Date,close,high,low,open,margin,Volume,sentiment,compound_score
02/01/2014,2025,2025,1963,1975,50,63984000,Positive,"0,5986"
03/01/2014,1950,2025,1938,2013,-63,105794000,Negative,"-0,1843"
06/01/2014,1913,1963,1900,1950,-37,51674800,Negative,"-0,1695"
07/01/2014,1906,1931,1900,1913,-7,81169200,Negative,"-0,2542"
08/01/2014,1956,1963,1913,1925,31,59954000,Positive,"0,5808"
09/01/2014,1950,1981,1925,1956,-6,71207200,Negative,"-0,289"
10/01/2014,2063,2094,1950,1950,113,153947200,Positive,"0,2032"
13/01/2014,2200,2200,2119,2125,75,228783600,Positive,"0,5944"
15/01/2014,2200,2381,2181,2206,-6,220250000,Negative,"-0,3431"
16/01/2014,2156,2225,2156,2219,-63,76988000,Negative,"-0,1967"
17/01/2014,2188,2200,2156,2156,32,58350000,Positive,"0,175"
20/01/2014,2188,2200,2169,2200,-12,27171600,Negative,"-0,1027"
21/01/2014,2194,2206,2188,2200,-6,59725600,Negative,"-0,4746"
22/01/2014,2238,2244,2181,2200,38,110857200,Positive,"0,3859"
23/01/2014,2219,2269,2219,2250,-31,109866800,Negative,"-0,4545"
24/01/2014,2169,2225,2156,2169,0,109728400,Positive,"0,3192"
27/01/2014,2075,2100,2038,2063,12,210759200,Positive,"0,6519"
28/01/2014,2069,2088,2038,2063,6,164112800,Positive,"0,8106"
29/01/2014,2175,2188,2075,2088,87,190262800,Positive,"0,413"
30/01/2014,2175,2175,2094,2113,62,132577200,Positive,"0,7833"
03/02/2014,2175,2206,2138,2206,-31,108214000,Negative,"-0,3153"
04/02/2014,2131,2156,2100,2131,0,95244800,Positive,"0,9254"
05/02/2014,2150,2163,2125,2163,-13,84726400,Negative,"-0,3519"
06/02/2014,2156,2163,2125,2163,-7,70481600,Negative,"-0,1817"
07/02/2014,2194,2213,2163,2169,25,101737200,Positive,"0,9833"
10/02/2014,2188,2231,2188,2213,-25,72448800,Negative,"-0,4896"
11/02/2014,2238,2263,2213,2219,19,206115200,Positive,"0,569"
12/02/2014,2244,2275,2219,2269,-25,131831600,Negative,"-0,4515"
13/02/2014,2250,2250,2231,2250,0,59296000,Positive,"0,0101"
14/02/2014,2256,2263,2238,2250,6,107262000,Positive,"0,3185"
17/02/2014,2288,2294,2263,2269,19,160782000,Positive,"0,8711"
18/02/2014,2281,2294,2263,2288,-7,114412800,Negative,"-0,1942"
19/02/2014,2281,2300,2263,2281,0,168598000,Positive,"0,9566"
20/02/2014,2306,2319,2275,2275,31,147004400,Positive,"0,555"
21/02/2014,2356,2356,2306,2313,43,195956800,Positive,"0,3266"
24/02/2014,2350,2413,2344,2375,-25,147883200,Negative,"-0,1908"
25/02/2014,2263,2375,2256,2375,-112,125208400,Negative,"-0,308"
26/02/2014,2238,2275,2206,2250,-12,222663200,Negative,"-0,1193"
27/02/2014,2250,2269,2231,2238,12,89265200,Positive,"0,5387"
28/02/2014,2275,2281,2238,2263,12,130770000,Positive,"0,5255"
03/03/2014,2275,2275,2250,2250,25,128786400,Positive,"0,1295"
04/03/2014,2281,2300,2256,2275,6,137225200,Positive,"0,9537"
05/03/2014,2350,2350,2294,2300,50,189594000,Positive,"0,2778"
06/03/2014,2350,2369,2344,2369,-19,95042800,Negative,"-0,1975"
07/03/2014,2313,2375,2306,2375,-62,68054000,Negative,"-0,1408"
10/03/2014,2300,2344,2275,2344,-44,85980000,Negative,"-0,2617"
11/03/2014,2344,2350,2300,2313,31,122784000,Positive,"0,427"
12/03/2014,2306,2338,2294,2306,0,78838000,Positive,"0,5154"
13/03/2014,2325,2325,2300,2300,25,71212800,Positive,"0,2271"
14/03/2014,2538,2563,2288,2300,238,379488800,Positive,"0,1822"
17/03/2014,2494,2538,2431,2500,-6,226867600,Negative,"-0,2324"
18/03/2014,2431,2500,2431,2475,-44,131869200,Negative,"-0,2991"
19/03/2014,2444,2463,2425,2431,13,128559200,Positive,"0,2338"
20/03/2014,2338,2438,2331,2438,-100,237560400,Negative,"-0,1972"
21/03/2014,2344,2375,2331,2356,-12,151603200,Negative,"-0,2328"
24/03/2014,2375,2394,2350,2375,0,108480800,Positive,"0,7223"
25/03/2014,2381,2381,2356,2363,18,79857600,Positive,"0,6664"
26/03/2014,2394,2419,2375,2394,0,127667600,Positive,"0,3669"
27/03/2014,2350,2388,2350,2350,0,105750800,Positive,"0,8922"
28/03/2014,2363,2400,2350,2381,-18,376191600,Negative,"-0,4113"
01/04/2014,2488,2488,2394,2394,94,268127600,Positive,"0,3727"
02/04/2014,2538,2550,2494,2500,38,178996000,Positive,"0,4374"
03/04/2014,2575,2575,2525,2550,25,157111200,Positive,"0,6336"
04/04/2014,2531,2588,2506,2581,-50,96803200,Negative,"-0,2093"
07/04/2014,2563,2569,2513,2531,32,135627200,Positive,"0,8698"
08/04/2014,2563,2575,2538,2575,-12,95152000,Negative,"-0,2308"
09/04/2014,2563,2563,2563,2563,0,0,Positive,"0,2258"
10/04/2014,2413,2438,2381,2388,25,450579200,Positive,"0,3795"
11/04/2014,2425,2450,2388,2400,25,184430400,Positive,"0,9415"
14/04/2014,2438,2444,2419,2419,19,142453200,Positive,"0,7691"
15/04/2014,2438,2456,2438,2450,-12,76331600,Negative,"-0,1221"
16/04/2014,2494,2506,2450,2456,38,106918800,Positive,"0,402"
17/04/2014,2463,2525,2444,2519,-56,147078800,Negative,"-0,4773"
21/04/2014,2456,2469,2450,2469,-13,38727200,Negative,"-0,1463"
22/04/2014,2463,2481,2431,2469,-6,115042000,Negative,"-0,2684"
23/04/2014,2475,2488,2456,2463,12,80303200,Positive,"0,4422"
24/04/2014,2469,2475,2450,2456,13,69398000,Positive,"0,8023"
25/04/2014,2475,2500,2463,2469,6,71704000,Positive,"0,2516"
28/04/2014,2438,2500,2431,2500,-62,116084400,Negative,"-0,4193"
29/04/2014,2450,2475,2431,2475,-25,46608800,Negative,"-0,2755"
30/04/2014,2456,2463,2444,2450,6,93242400,Positive,"0,4558"
02/05/2014,2469,2494,2463,2475,-6,86257200,Negative,"-0,2841"
05/05/2014,2463,2488,2444,2469,-6,56014400,Negative,"-0,4025"
06/05/2014,2469,2475,2456,2475,-6,21791600,Negative,"-0,3771"
07/05/2014,2494,2500,2463,2463,31,82346400,Positive,"0,2813"
08/05/2014,2506,2513,2488,2506,0,43227200,Positive,"0,5617"
09/05/2014,2519,2525,2488,2525,-6,48956000,Negative,"-0,2717"
12/05/2014,2494,2525,2494,2525,-31,70641200,Negative,"-0,4666"
13/05/2014,2519,2519,2500,2519,0,61065600,Positive,"0,1302"
14/05/2014,2581,2588,2519,2525,56,219808400,Positive,"0,7234"
16/05/2014,2650,2650,2569,2575,75,202264800,Positive,"0,9071"
19/05/2014,2656,2706,2606,2656,0,225986800,Positive,"0,0733"
20/05/2014,2525,2663,2500,2525,0,210495200,Positive,"0,449"
21/05/2014,2538,2550,2506,2538,0,69045200,Positive,"0,1595"
22/05/2014,2594,2606,2550,2594,0,106400400,Positive,"0,5999"
23/05/2014,2594,2606,2575,2594,0,51238400,Positive,"0,3061"
26/05/2014,2581,2613,2556,2581,0,35746000,Positive,"0,8539"
28/05/2014,2594,2600,2569,2594,0,79694000,Positive,"0,8537"
30/05/2014,2544,2594,2513,2544,0,247178400,Positive,"0,4308"
02/06/2014,2550,2563,2531,2550,0,76876800,Positive,"0,064"
03/06/2014,2550,2556,2519,2550,0,126123600,Positive,"0,0178"
04/06/2014,2538,2556,2525,2538,0,106749600,Positive,"0,1628"
05/06/2014,2550,2550,2506,2550,0,66263600,Positive,"0,897"
06/06/2014,2519,2544,2506,2519,0,107951200,Positive,"0,7189"
09/06/2014,2450,2544,2438,2450,0,134515200,Positive,"0,7349"
10/06/2014,2494,2494,2456,2494,0,148333200,Positive,"0,074"
11/06/2014,2488,2494,2463,2488,0,98108000,Positive,"0,1472"
12/06/2014,2481,2494,2463,2481,0,104930800,Positive,"0,2619"
13/06/2014,2481,2488,2463,2481,0,82041200,Positive,"0,6747"
16/06/2014,2463,2481,2438,2463,0,61751200,Positive,"0,2129"
17/06/2014,2475,2481,2444,2475,0,60293600,Positive,"0,5485"
18/06/2014,2469,2481,2463,2469,0,87876000,Positive,"0,2423"
19/06/2014,2450,2481,2444,2450,0,105030000,Positive,"0,5232"
20/06/2014,2450,2469,2444,2450,0,67474800,Positive,"0,0872"
23/06/2014,2438,2469,2431,2438,0,92584000,Positive,"0,6804"
24/06/2014,2444,2456,2431,2444,0,62032400,Positive,"0,5667"
25/06/2014,2438,2456,2425,2438,0,103590400,Positive,"0,9132"
26/06/2014,2463,2475,2438,2463,0,149123600,Positive,"0,3047"
27/06/2014,2413,2463,2406,2413,0,133020400,Positive,"0,4047"
30/06/2014,2431,2431,2406,2431,0,80812800,Positive,"0,6287"
01/07/2014,2456,2463,2425,2456,0,67317200,Positive,"0,797"
02/07/2014,2463,2469,2444,2463,0,107994400,Positive,"0,5358"
03/07/2014,2413,2469,2406,2413,0,177824000,Positive,"0,5435"
04/07/2014,2419,2438,2413,2419,0,70222800,Positive,"0,5343"
07/07/2014,2481,2481,2431,2481,0,255845600,Positive,"0,683"
08/07/2014,2538,2556,2494,2538,0,408720400,Positive,"0,8025"
09/07/2014,2538,2538,2538,2538,0,0,Positive,"0,6146"
10/07/2014,2619,2750,2594,2619,0,801523200,Positive,"0,7687"
11/07/2014,2625,2625,2569,2625,0,186758800,Positive,"0,4669"
14/07/2014,2625,2631,2588,2625,0,118788000,Positive,"0,2731"
15/07/2014,2638,2644,2619,2638,0,137040000,Positive,"0,0164"
16/07/2014,2650,2675,2638,2650,0,109010800,Positive,"0,5102"
17/07/2014,2656,2669,2631,2656,0,107004800,Positive,"0,4232"
18/07/2014,2656,2675,2625,2656,0,95748000,Positive,"0,1161"
21/07/2014,2663,2688,2650,2663,0,127907200,Positive,"0,036"
22/07/2014,2619,2681,2600,2619,0,232130800,Positive,"0,9395"
23/07/2014,2625,2663,2613,2625,0,56408400,Positive,"0,2918"
24/07/2014,2613,2631,2594,2613,0,111699200,Positive,"0,1239"
25/07/2014,2563,2588,2538,2563,0,155539600,Positive,"0,0588"
04/08/2014,2569,2569,2506,2569,0,154489200,Positive,"0,3137"
05/08/2014,2600,2600,2544,2600,0,73754000,Positive,"0,2946"
06/08/2014,2569,2588,2556,2569,0,88148800,Positive,"0,7578"
07/08/2014,2550,2563,2513,2550,0,94302400,Positive,"0,4019"
08/08/2014,2550,2556,2538,2550,0,59980800,Positive,"0,2797"
11/08/2014,2619,2625,2569,2619,0,67873600,Positive,"0,3451"
12/08/2014,2625,2638,2606,2625,0,129655600,Positive,"0,9815"
13/08/2014,2625,2625,2588,2625,0,52008000,Positive,"0,2617"
14/08/2014,2619,2631,2613,2619,0,73004400,Positive,"0,8871"
15/08/2014,2613,2625,2606,2613,0,23361600,Positive,"0,6789"
18/08/2014,2619,2631,2606,2619,0,98694400,Positive,"0,755"
19/08/2014,2631,2638,2619,2631,0,94816400,Positive,"0,3708"
20/08/2014,2638,2644,2631,2638,0,82936400,Positive,"0,0261"
21/08/2014,2638,2656,2625,2638,0,105621600,Positive,"0,6248"
22/08/2014,2631,2663,2619,2631,0,85906400,Positive,"0,3406"
25/08/2014,2644,2650,2613,2644,0,54252400,Positive,"0,0914"
26/08/2014,2619,2650,2613,2619,0,54252000,Positive,"0,5663"
27/08/2014,2638,2644,2625,2638,0,62226400,Positive,"0,2597"
28/08/2014,2631,2644,2613,2631,0,35008400,Positive,"0,6387"
29/08/2014,2594,2638,2594,2594,0,73210800,Positive,"0,8399"
01/09/2014,2625,2625,2594,2625,0,24629200,Positive,"0,297"
02/09/2014,2625,2638,2625,2625,0,54608000,Positive,"0,2483"
03/09/2014,2638,2644,2625,2638,0,66228000,Positive,"0,6112"
04/09/2014,2638,2650,2625,2638,0,56440800,Positive,"0,9298"
05/09/2014,2619,2650,2613,2619,0,44564800,Positive,"0,8858"
08/09/2014,2638,2663,2613,2638,0,57887200,Positive,"0,2533"
09/09/2014,2619,2638,2613,2619,0,28824000,Positive,"0,4832"
10/09/2014,2613,2625,2594,2613,0,82266000,Positive,"0,1516"
11/09/2014,2600,2625,2594,2600,0,113945600,Positive,"0,458"
12/09/2014,2550,2594,2550,2550,0,129725600,Positive,"0,9223"
15/09/2014,2556,2563,2513,2556,0,88174800,Positive,"0,8132"
16/09/2014,2538,2556,2531,2538,0,75382800,Positive,"0,6653"
17/09/2014,2569,2588,2544,2569,0,53077600,Positive,"0,0767"
18/09/2014,2606,2613,2575,2606,0,49814000,Positive,"0,6042"
19/09/2014,2631,2650,2606,2631,0,105775600,Positive,"0,7175"
22/09/2014,2663,2663,2619,2663,0,107543200,Positive,"0,0697"
23/09/2014,2675,2675,2644,2675,0,95076400,Positive,"0,3549"
24/09/2014,2638,2663,2638,2638,0,44105200,Positive,"0,6312"
25/09/2014,2631,2663,2581,2631,0,158243200,Positive,"0,4985"
26/09/2014,2513,2550,2506,2513,0,250778800,Positive,"0,8379"
29/09/2014,2519,2525,2456,2519,0,155296800,Positive,"0,6679"
30/09/2014,2519,2544,2500,2519,0,122798400,Positive,"0,213"
01/10/2014,2525,2594,2519,2525,0,89411200,Positive,"0,6822"
02/10/2014,2475,2544,2475,2475,0,143686400,Positive,"0,6565"
03/10/2014,2413,2494,2388,2413,0,165436800,Positive,"0,949"
06/10/2014,2456,2463,2413,2456,0,97244800,Positive,"0,7331"
07/10/2014,2438,2475,2431,2438,0,108166000,Positive,"0,9983"
08/10/2014,2375,2425,2363,2375,0,248045200,Positive,"0,5926"
09/10/2014,2388,2419,2388,2388,0,75312400,Positive,"0,8519"
10/10/2014,2388,2388,2338,2388,0,101417600,Positive,"0,5119"
13/10/2014,2350,2369,2331,2350,0,127360400,Positive,"0,1539"
14/10/2014,2363,2381,2325,2363,0,96061600,Positive,"0,4282"
15/10/2014,2413,2425,2375,2413,0,89523600,Positive,"0,1399"
16/10/2014,2413,2425,2375,2413,0,78677600,Positive,"0,9066"
17/10/2014,2481,2525,2413,2481,0,197240400,Positive,"0,3428"
20/10/2014,2531,2550,2494,2531,0,152256400,Positive,"0,9443"
21/10/2014,2506,2538,2488,2506,0,66651200,Positive,"0,5237"
22/10/2014,2525,2531,2500,2525,0,66994800,Positive,"0,9553"
23/10/2014,2544,2550,2513,2544,0,72442400,Positive,"0,3106"
24/10/2014,2525,2556,2506,2525,0,81342400,Positive,"0,4188"
27/10/2014,2494,2544,2488,2494,0,67994000,Positive,"0,8112"
28/10/2014,2500,2513,2481,2500,0,46372400,Positive,"0,6394"
29/10/2014,2544,2544,2506,2544,0,87597600,Positive,"0,4526"
30/10/2014,2550,2550,2519,2550,0,54349200,Positive,"0,1093"
31/10/2014,2588,2588,2550,2588,0,71242800,Positive,"0,1542"
03/11/2014,2594,2606,2563,2594,0,44479600,Positive,"0,2411"
04/11/2014,2625,2631,2588,2625,0,95046800,Positive,"0,8597"
05/11/2014,2606,2625,2575,2606,0,41149600,Positive,"0,0298"
06/11/2014,2581,2625,2581,2581,0,83054800,Positive,"0,3838"
07/11/2014,2544,2625,2525,2544,0,51160800,Positive,"0,199"
10/11/2014,2575,2581,2563,2575,0,58935600,Positive,"0,4472"
11/11/2014,2631,2656,2575,2631,0,104714400,Positive,"0,9065"
12/11/2014,2638,2681,2631,2638,0,98669600,Positive,"0,9076"
13/11/2014,2606,2631,2581,2606,0,63121200,Positive,"0,33"
14/11/2014,2625,2638,2594,2625,0,40744800,Positive,"0,3025"
17/11/2014,2619,2644,2619,2625,-6,71210000,Negative,"-0,1817"
18/11/2014,2625,2663,2613,2625,0,86135600,Positive,"0,4128"
19/11/2014,2631,2656,2619,2631,0,84622800,Positive,"0,2787"
20/11/2014,2613,2631,2606,2613,0,41546000,Positive,"0,1702"
21/11/2014,2594,2625,2588,2594,0,54756400,Positive,"0,4825"
24/11/2014,2625,2638,2613,2625,0,66688400,Positive,"0,6633"
25/11/2014,2613,2644,2613,2613,0,90611600,Positive,"0,5775"
26/11/2014,2631,2638,2619,2631,0,46545200,Positive,"0,5563"
27/11/2014,2619,2631,2613,2619,0,40903600,Positive,"0,4451"
28/11/2014,2631,2638,2613,2631,0,44246000,Positive,"0,0115"
01/12/2014,2656,2663,2631,2638,18,73759200,Positive,"0,7588"
02/12/2014,2688,2700,2656,2663,25,139652400,Positive,"0,2774"
03/12/2014,2675,2694,2669,2688,-13,50463600,Negative,"-0,1545"
04/12/2014,2656,2688,2650,2675,-19,42235600,Negative,"-0,1592"
05/12/2014,2663,2694,2663,2681,-18,40322400,Negative,"-0,2811"
08/12/2014,2638,2694,2619,2688,-50,69020800,Negative,"-0,3367"
09/12/2014,2631,2663,2625,2631,0,43210000,Positive,"0,8832"
10/12/2014,2694,2700,2638,2650,44,67644800,Positive,"0,1399"
11/12/2014,2681,2700,2644,2644,37,65913200,Positive,"0,2753"
12/12/2014,2688,2719,2675,2675,13,75546800,Positive,"0,4864"
15/12/2014,2631,2663,2625,2650,-19,90029600,Negative,"-0,4633"
16/12/2014,2556,2613,2544,2613,-57,205105600,Negative,"-0,3933"
17/12/2014,2650,2663,2531,2550,100,97264000,Positive,"0,3205"
18/12/2014,2663,2694,2650,2688,-25,95119600,Negative,"-0,2909"
19/12/2014,2663,2688,2656,2688,-25,93536800,Negative,"-0,1086"
22/12/2014,2656,2688,2656,2675,-19,32630400,Negative,"-0,4835"
23/12/2014,2650,2681,2650,2675,-25,31940800,Negative,"-0,2853"
24/12/2014,2675,2681,2663,2669,6,35045200,Positive,"0,8352"
29/12/2014,2681,2694,2656,2675,6,28136000,Positive,"0,9413"
30/12/2014,2694,2700,2669,2669,25,48592000,Positive,"0,2594"
02/01/2015,2706,2713,2688,2694,12,84546800,Positive,"0,369"
05/01/2015,2700,2713,2688,2713,-13,33363200,Negative,"-0,1099"
06/01/2015,2681,2706,2669,2688,-7,58600000,Negative,"-0,3883"
07/01/2015,2713,2713,2681,2688,25,50244400,Positive,"0,3621"
08/01/2015,2738,2744,2719,2725,13,63649600,Positive,"0,5819"
09/01/2015,2781,2806,2738,2750,31,170824800,Positive,"0,047"
12/01/2015,2706,2781,2706,2756,-50,53126800,Negative,"-0,3074"
13/01/2015,2688,2719,2656,2719,-31,80360800,Negative,"-0,1079"
14/01/2015,2681,2750,2681,2706,-25,59552800,Negative,"-0,3773"
15/01/2015,2725,2738,2688,2725,0,102689600,Positive,"0,5352"
16/01/2015,2675,2719,2675,2688,-13,95469200,Negative,"-0,4832"
19/01/2015,2681,2725,2663,2663,18,100006000,Positive,"0,741"
20/01/2015,2688,2688,2650,2669,19,146990400,Positive,"0,4181"
21/01/2015,2744,2744,2663,2688,56,74948000,Positive,"0,3494"
22/01/2015,2750,2756,2719,2744,6,71265600,Positive,"0,9769"
23/01/2015,2844,2844,2769,2769,75,134785600,Positive,"0,575"
26/01/2015,2775,2800,2725,2788,-13,150832800,Negative,"-0,4649"
27/01/2015,2769,2781,2750,2750,19,69340000,Positive,"0,1711"
28/01/2015,2744,2794,2744,2788,-44,64691600,Negative,"-0,4217"
29/01/2015,2744,2756,2731,2738,6,48526400,Positive,"0,9018"
30/01/2015,2750,2813,2750,2781,-31,98195200,Negative,"-0,2071"
02/02/2015,2813,2825,2738,2750,63,107672400,Positive,"0,3454"
03/02/2015,2838,2844,2819,2838,0,79597600,Positive,"0,8879"
04/02/2015,2844,2863,2800,2850,-6,135804000,Negative,"-0,3018"
05/02/2015,2813,2838,2806,2831,-18,111271200,Negative,"-0,3132"
06/02/2015,2838,2869,2825,2838,0,107253600,Positive,"0,4988"
09/02/2015,2925,2956,2850,2850,75,128836000,Positive,"0,1281"
10/02/2015,2906,2925,2888,2900,6,79794000,Positive,"0,5358"
11/02/2015,2938,2981,2925,2956,-18,123487600,Negative,"-0,2531"
12/02/2015,2944,2994,2938,2981,-37,98841600,Negative,"-0,1866"
13/02/2015,2975,2988,2963,2969,6,84660800,Positive,"0,9714"
16/02/2015,2944,2988,2938,2975,-31,85716800,Negative,"-0,3654"
17/02/2015,2925,2963,2913,2944,-19,28532800,Negative,"-0,1846"
18/02/2015,2981,3075,2969,3000,-19,167238000,Negative,"-0,4406"
20/02/2015,3019,3050,2994,2994,25,74989600,Positive,"0,4153"
23/02/2015,2969,3013,2956,2975,-6,118434000,Negative,"-0,2969"
24/02/2015,2969,2988,2944,2950,19,81622800,Positive,"0,5025"
25/02/2015,2975,2981,2963,2975,0,62958800,Positive,"0,3252"
26/02/2015,2969,2975,2950,2950,19,76328800,Positive,"0,7367"
27/02/2015,3000,3019,2950,2975,25,85468000,Positive,"0,8582"
02/03/2015,3000,3006,2975,2975,25,96851600,Positive,"0,4197"
03/03/2015,2975,3025,2975,3025,-50,57682400,Negative,"-0,3921"
04/03/2015,2963,2988,2956,2969,-6,47226000,Negative,"-0,1483"
05/03/2015,2956,2994,2950,2956,0,67612800,Positive,"0,172"
06/03/2015,3025,3025,2963,2975,50,77888400,Positive,"0,7326"
09/03/2015,2950,3006,2938,3000,-50,105046000,Negative,"-0,2368"
10/03/2015,3006,3019,2938,2956,50,69672800,Positive,"0,7605"
11/03/2015,2969,3006,2963,2975,-6,98384400,Negative,"-0,4584"
12/03/2015,2975,3006,2963,2963,12,45096400,Positive,"0,3966"
13/03/2015,2975,3013,2950,2994,-19,68090000,Negative,"-0,24"
16/03/2015,3000,3019,2963,2975,25,54288000,Positive,"0,5988"
17/03/2015,2994,3019,2981,3013,-19,51684800,Negative,"-0,167"
18/03/2015,2988,3000,2963,2963,25,54372400,Positive,"0,484"
19/03/2015,3050,3050,3000,3025,25,74428400,Positive,"0,5492"
20/03/2015,3050,3075,3019,3025,25,83046000,Positive,"0,6146"
23/03/2015,3044,3069,3044,3069,-25,36825600,Negative,"-0,1901"
24/03/2015,3019,3056,3013,3038,-19,59234400,Negative,"-0,4609"
25/03/2015,3006,3044,3000,3013,-7,59409600,Negative,"-0,4325"
26/03/2015,3013,3038,2988,3006,7,49491600,Positive,"0,7552"
27/03/2015,2988,3006,2963,2975,13,60455600,Positive,"0,6333"
30/03/2015,3025,3075,3000,3013,12,75822800,Positive,"0,9613"
31/03/2015,3119,3119,3063,3081,38,83456000,Positive,"0,6916"
01/04/2015,3069,3138,3025,3119,-50,110690000,Negative,"-0,3359"
02/04/2015,3069,3094,3006,3088,-19,56737600,Negative,"-0,3927"
06/04/2015,3044,3081,3025,3075,-31,64304400,Negative,"-0,4955"
07/04/2015,3044,3050,3019,3050,-6,95657600,Negative,"-0,2775"
08/04/2015,3019,3050,2994,3050,-31,113430800,Negative,"-0,3245"
09/04/2015,3000,3019,2988,3019,-19,62660800,Negative,"-0,3347"
10/04/2015,3000,3013,2994,3006,-6,52790800,Negative,"-0,4738"
13/04/2015,3013,3013,2988,3013,0,80286400,Positive,"0,4354"
14/04/2015,2963,3000,2944,2975,-12,104148800,Negative,"-0,4147"
15/04/2015,3013,3013,2956,2975,38,47940400,Positive,"0,0467"
16/04/2015,3000,3025,2994,3025,-25,55566800,Negative,"-0,1348"
17/04/2015,3000,3019,2981,3019,-19,40751200,Negative,"-0,225"
20/04/2015,3019,3019,2975,3000,19,44488800,Positive,"0,7987"
21/04/2015,3038,3038,3013,3025,13,69309200,Positive,"0,3117"
22/04/2015,3006,3038,3006,3038,-32,44750400,Negative,"-0,1103"
23/04/2015,3000,3013,2988,2994,6,64157200,Positive,"0,7569"
24/04/2015,2975,3019,2975,3006,-31,53536400,Negative,"-0,1663"
27/04/2015,2813,2950,2775,2950,-137,308830800,Negative,"-0,4048"
28/04/2015,2725,2744,2663,2725,0,279868000,Positive,"0,023"
29/04/2015,2638,2738,2588,2725,-87,316523200,Negative,"-0,1505"
30/04/2015,2688,2700,2619,2644,44,195589600,Positive,"0,1611"
04/05/2015,2794,2825,2675,2694,100,189657600,Positive,"0,1578"
05/05/2015,2806,2844,2781,2800,6,153516400,Positive,"0,326"
06/05/2015,2850,2850,2756,2756,94,128029200,Positive,"0,0588"
07/05/2015,2794,2838,2763,2781,13,111124000,Positive,"0,7462"
08/05/2015,2794,2838,2781,2831,-37,51254800,Negative,"-0,2457"
11/05/2015,2781,2825,2781,2794,-13,34354800,Negative,"-0,1186"
12/05/2015,2819,2838,2781,2794,25,96191200,Positive,"0,8844"
13/05/2015,2813,2825,2788,2788,25,138148400,Positive,"0,998"
15/05/2015,2738,2806,2731,2800,-62,102507600,Negative,"-0,1272"
18/05/2015,2775,2788,2738,2738,37,106922000,Positive,"0,9511"
19/05/2015,2800,2806,2763,2775,25,66192000,Positive,"0,653"
20/05/2015,2819,2838,2794,2825,-6,74743200,Negative,"-0,446"
21/05/2015,2906,2913,2813,2838,68,120901600,Positive,"0,5057"
22/05/2015,2856,2931,2838,2925,-69,83152000,Negative,"-0,2927"
25/05/2015,2788,2825,2781,2813,-25,100023600,Negative,"-0,2342"
26/05/2015,2781,2825,2781,2788,-7,88446000,Negative,"-0,1506"
27/05/2015,2750,2800,2750,2750,0,98622000,Positive,"0,8324"
28/05/2015,2700,2775,2688,2756,-56,160551600,Negative,"-0,3651"
29/05/2015,2694,2706,2681,2688,6,158411600,Positive,"0,0199"
01/06/2015,2675,2706,2650,2700,-25,116245200,Negative,"-0,3653"
03/06/2015,2638,2675,2613,2656,-18,145928400,Negative,"-0,1572"
04/06/2015,2631,2650,2600,2631,0,100190400,Positive,"0,7175"
05/06/2015,2669,2669,2613,2631,38,67930800,Positive,"0,9737"
08/06/2015,2575,2656,2563,2644,-69,97918000,Negative,"-0,2011"
09/06/2015,2488,2525,2425,2525,-37,196405200,Negative,"-0,2077"
10/06/2015,2469,2519,2431,2488,-19,110615600,Negative,"-0,3895"
11/06/2015,2419,2500,2406,2488,-69,106057200,Negative,"-0,422"
12/06/2015,2475,2494,2419,2425,50,108184000,Positive,"0,1651"
15/06/2015,2356,2463,2356,2450,-94,92020000,Negative,"-0,4626"
16/06/2015,2388,2419,2338,2375,13,93402800,Positive,"0,4664"
17/06/2015,2456,2488,2413,2413,43,170708800,Positive,"0,4189"
18/06/2015,2419,2494,2413,2475,-56,116189200,Negative,"-0,3947"
19/06/2015,2500,2513,2463,2475,25,139460400,Positive,"0,0557"
22/06/2015,2494,2525,2481,2519,-25,51412000,Negative,"-0,3492"
23/06/2015,2513,2519,2469,2500,13,115338000,Positive,"0,8793"
24/06/2015,2475,2563,2456,2525,-50,136800000,Negative,"-0,1474"
25/06/2015,2500,2544,2469,2488,12,127306400,Positive,"0,2001"
26/06/2015,2525,2538,2481,2519,6,42988000,Positive,"0,8818"
29/06/2015,2506,2513,2475,2488,18,51673600,Positive,"0,604"
30/06/2015,2513,2544,2488,2531,-18,66377600,Negative,"-0,1382"
01/07/2015,2500,2531,2494,2531,-31,68338800,Negative,"-0,3451"
02/07/2015,2519,2538,2475,2475,44,88189600,Positive,"0,3936"
03/07/2015,2544,2550,2500,2531,13,44312000,Positive,"0,1196"
06/07/2015,2481,2525,2475,2506,-25,40962400,Negative,"-0,1739"
07/07/2015,2538,2538,2500,2513,25,76844800,Positive,"0,8768"
08/07/2015,2488,2513,2475,2500,-12,68092000,Negative,"-0,4221"
09/07/2015,2475,2500,2456,2475,0,67824800,Positive,"0,3669"
10/07/2015,2500,2513,2488,2494,6,93061200,Positive,"0,1407"
13/07/2015,2513,2519,2494,2500,13,121620800,Positive,"0,2953"
14/07/2015,2531,2550,2519,2525,6,93382000,Positive,"0,5518"
15/07/2015,2500,2544,2488,2544,-44,58466000,Negative,"-0,2362"
22/07/2015,2600,2600,2531,2550,50,146678400,Positive,"0,8837"
23/07/2015,2525,2594,2525,2575,-50,80344400,Negative,"-0,3876"
24/07/2015,2500,2525,2488,2513,-13,101181200,Negative,"-0,2579"
27/07/2015,2388,2513,2381,2494,-106,139128000,Negative,"-0,368"
28/07/2015,2344,2356,2319,2344,0,107764400,Positive,"0,9483"
29/07/2015,2375,2388,2344,2363,12,111259600,Positive,"0,2119"
30/07/2015,2381,2413,2363,2400,-19,115432800,Negative,"-0,3709"
31/07/2015,2381,2394,2331,2375,6,226184800,Positive,"0,3063"
03/08/2015,2425,2431,2350,2350,75,189702800,Positive,"0,5203"
04/08/2015,2381,2444,2369,2425,-44,172058000,Negative,"-0,3853"
05/08/2015,2450,2450,2381,2400,50,182880400,Positive,"0,646"
06/08/2015,2450,2519,2438,2475,-25,138502000,Negative,"-0,4068"
07/08/2015,2413,2444,2406,2444,-31,60834400,Negative,"-0,367"
10/08/2015,2381,2438,2363,2438,-57,64787200,Negative,"-0,3527"
11/08/2015,2288,2413,2281,2406,-118,166308400,Negative,"-0,368"
12/08/2015,2200,2250,2131,2250,-50,199885200,Negative,"-0,1352"
13/08/2015,2275,2294,2213,2219,56,148333600,Positive,"0,7606"
14/08/2015,2250,2275,2238,2275,-25,122529600,Negative,"-0,3313"
18/08/2015,2200,2250,2188,2238,-38,83244000,Negative,"-0,1526"
19/08/2015,2175,2219,2156,2200,-25,92040000,Negative,"-0,1902"
20/08/2015,2175,2175,2131,2150,25,87566000,Positive,"0,7302"
21/08/2015,2125,2138,2100,2125,0,136115600,Positive,"0,0847"
24/08/2015,2044,2088,2031,2069,-25,129089600,Negative,"-0,3663"
25/08/2015,2125,2163,2050,2050,75,296784800,Positive,"0,8168"
26/08/2015,2138,2169,2088,2138,0,202368000,Positive,"0,4923"
27/08/2015,2250,2256,2175,2188,62,219296800,Positive,"0,8927"
28/08/2015,2269,2319,2244,2300,-31,174394000,Negative,"-0,1306"
31/08/2015,2275,2281,2238,2244,31,107618400,Positive,"0,9317"
01/09/2015,2181,2250,2169,2250,-69,74196800,Negative,"-0,3317"
02/09/2015,2200,2219,2150,2175,25,66349600,Positive,"0,9461"
03/09/2015,2206,2238,2194,2213,-7,95144800,Negative,"-0,3056"
04/09/2015,2206,2219,2181,2200,6,41096400,Positive,"0,8518"
07/09/2015,2188,2206,2175,2200,-12,54352800,Negative,"-0,4505"
08/09/2015,2200,2206,2175,2188,12,57412800,Positive,"0,3587"
09/09/2015,2175,2231,2150,2219,-44,135401200,Negative,"-0,3612"
10/09/2015,2150,2163,2138,2163,-13,70959200,Negative,"-0,1069"
11/09/2015,2163,2175,2163,2175,-12,46889600,Negative,"-0,3695"
14/09/2015,2163,2175,2150,2175,-12,41073600,Negative,"-0,2398"
15/09/2015,2175,2175,2150,2156,19,32625200,Positive,"0,2865"
16/09/2015,2163,2181,2150,2175,-12,32254800,Negative,"-0,4003"
17/09/2015,2163,2181,2150,2156,7,112392000,Positive,"0,1726"
18/09/2015,2163,2188,2156,2175,-12,94615200,Negative,"-0,3549"
21/09/2015,2150,2175,2150,2163,-13,66774000,Negative,"-0,252"
22/09/2015,2150,2163,2144,2150,0,34276400,Positive,"0,7043"
23/09/2015,2013,2125,2006,2125,-112,75746400,Negative,"-0,1681"
25/09/2015,1931,2000,1931,2000,-69,138808000,Negative,"-0,2747"
28/09/2015,1881,1944,1881,1931,-50,63378800,Negative,"-0,119"
29/09/2015,1944,1944,1788,1825,119,63959200,Positive,"0,0575"
30/09/2015,1981,2000,1956,1963,18,118378400,Positive,"0,5309"
01/10/2015,1994,2031,1981,2000,-6,63633600,Negative,"-0,2675"
02/10/2015,1919,2000,1919,1994,-75,89269200,Negative,"-0,3717"
05/10/2015,2050,2050,1950,1963,87,56322400,Positive,"0,4666"
06/10/2015,2225,2231,2075,2075,150,179906000,Positive,"0,4861"
07/10/2015,2231,2269,2175,2250,-19,118109200,Negative,"-0,3936"
08/10/2015,2225,2244,2200,2231,-6,108926400,Negative,"-0,4517"
09/10/2015,2275,2319,2256,2263,12,177488400,Positive,"0,9091"
12/10/2015,2294,2306,2250,2250,44,66492800,Positive,"0,4088"
13/10/2015,2238,2294,2238,2281,-43,123736400,Negative,"-0,3788"
15/10/2015,2225,2275,2213,2238,-13,80592800,Negative,"-0,3275"
16/10/2015,2231,2269,2225,2225,6,65777200,Positive,"0,1978"
19/10/2015,2288,2288,2238,2238,50,54853200,Positive,"0,7624"
20/10/2015,2313,2313,2256,2288,25,65063600,Positive,"0,6296"
21/10/2015,2306,2350,2281,2281,25,65543200,Positive,"0,0861"
22/10/2015,2294,2331,2294,2319,-25,66396000,Negative,"-0,4046"
23/10/2015,2350,2363,2300,2338,12,142408000,Positive,"0,2115"
26/10/2015,2394,2406,2369,2375,19,145286400,Positive,"0,7969"
27/10/2015,2413,2413,2356,2375,38,80484400,Positive,"0,1189"
28/10/2015,2363,2406,2363,2381,-18,72526000,Negative,"-0,3231"
29/10/2015,2250,2356,2238,2350,-100,113545600,Negative,"-0,4286"
30/10/2015,2175,2231,2175,2206,-31,183069200,Negative,"-0,4189"
02/11/2015,2138,2175,2100,2169,-31,84406800,Negative,"-0,4929"
03/11/2015,2213,2269,2175,2175,38,133874000,Positive,"0,2975"
04/11/2015,2275,2288,2219,2219,56,104358000,Positive,"0,8536"
05/11/2015,2244,2288,2225,2281,-37,76689200,Negative,"-0,3092"
06/11/2015,2244,2269,2225,2225,19,39835600,Positive,"0,5563"
09/11/2015,2175,2225,2175,2200,-25,66005200,Negative,"-0,1064"
10/11/2015,2100,2175,2100,2131,-31,122132000,Negative,"-0,307"
11/11/2015,2044,2088,2038,2081,-37,122912000,Negative,"-0,1214"
12/11/2015,2094,2113,2044,2044,50,101481200,Positive,"0,8388"
13/11/2015,2169,2169,2069,2075,94,86066400,Positive,"0,5678"
16/11/2015,2125,2131,2088,2113,12,54983200,Positive,"0,2642"
17/11/2015,2156,2169,2131,2131,25,75114400,Positive,"0,0284"
18/11/2015,2156,2175,2138,2175,-19,49671200,Negative,"-0,2606"
19/11/2015,2194,2194,2169,2175,19,61782000,Positive,"0,7575"
20/11/2015,2169,2188,2144,2163,6,54798400,Positive,"0,7364"
23/11/2015,2181,2213,2181,2181,0,45954000,Positive,"0,6023"
24/11/2015,2175,2188,2150,2150,25,26436400,Positive,"0,7151"
25/11/2015,2231,2238,2175,2181,50,65648400,Positive,"0,4145"
26/11/2015,2319,2319,2225,2244,75,114857200,Positive,"0,0867"
27/11/2015,2244,2319,2244,2306,-62,50550800,Negative,"-0,1393"
30/11/2015,2125,2250,2125,2225,-100,291126000,Negative,"-0,3474"
01/12/2015,2225,2244,2188,2188,37,81230800,Positive,"0,021"
02/12/2015,2225,2244,2213,2231,-6,45067200,Negative,"-0,3223"
03/12/2015,2200,2231,2200,2213,-13,46170000,Negative,"-0,4089"
04/12/2015,2188,2206,2175,2200,-12,66563200,Negative,"-0,3624"
07/12/2015,2275,2288,2206,2213,62,65284000,Positive,"0,0825"
08/12/2015,2250,2269,2225,2250,0,75222000,Positive,"0,8276"
09/12/2015,2250,2250,2250,2250,0,0,Positive,"0,8369"
10/12/2015,2219,2219,2188,2200,19,79034800,Positive,"0,1602"
11/12/2015,2188,2238,2188,2231,-43,45985200,Negative,"-0,4954"
14/12/2015,2156,2156,2113,2125,31,78568800,Positive,"0,0979"
15/12/2015,2188,2188,2144,2169,19,55228000,Positive,"0,6862"
16/12/2015,2238,2238,2188,2213,25,87191200,Positive,"0,4825"
17/12/2015,2275,2288,2244,2288,-13,90298000,Negative,"-0,348"
18/12/2015,2181,2244,2181,2244,-63,93092000,Negative,"-0,1166"
21/12/2015,2219,2219,2181,2181,38,16910000,Positive,"0,3258"
22/12/2015,2219,2231,2200,2231,-12,44916000,Negative,"-0,1196"
23/12/2015,2219,2225,2188,2213,6,51713200,Positive,"0,5565"
28/12/2015,2250,2269,2175,2175,75,66709200,Positive,"0,7719"
29/12/2015,2281,2281,2269,2269,12,43552000,Positive,"0,1234"
30/12/2015,2313,2313,2275,2281,32,104390800,Positive,"0,4094"
04/01/2016,2313,2338,2269,2300,13,60667600,Neutral,0.0
05/01/2016,2344,2388,2313,2313,31,106152400,Neutral,0.0
06/01/2016,2338,2381,2338,2363,-25,106147600,Neutral,0.0
07/01/2016,2275,2313,2275,2288,-13,92196400,Neutral,0.0
08/01/2016,2319,2319,2275,2275,44,97109200,Neutral,0.0
11/01/2016,2275,2288,2250,2275,0,62974000,Neutral,0.0
12/01/2016,2300,2319,2275,2300,0,77847200,Neutral,0.0
13/01/2016,2338,2363,2300,2319,19,132198400,Neutral,0.0
14/01/2016,2338,2369,2275,2275,63,120844000,Positive,"0,8699"
15/01/2016,2319,2356,2319,2338,-19,41635600,Negative,"-0,2371"
18/01/2016,2319,2331,2313,2313,6,61618000,Positive,"0,5829"
19/01/2016,2344,2350,2306,2306,38,33891200,Positive,"0,7208"
20/01/2016,2331,2350,2325,2331,0,111518800,Neutral,0.0
21/01/2016,2325,2344,2313,2331,-6,111117200,Neutral,0.0
22/01/2016,2344,2350,2319,2325,19,102318000,Neutral,0.0
25/01/2016,2381,2388,2344,2350,31,52867200,Positive,"0,4223"
26/01/2016,2381,2388,2356,2363,18,68705200,Positive,"0,9963"
27/01/2016,2388,2400,2363,2388,0,97861600,Neutral,0.0
28/01/2016,2375,2388,2356,2388,-13,84751600,Neutral,0.0
29/01/2016,2400,2400,2356,2375,25,118885600,Neutral,0.0
01/02/2016,2406,2413,2344,2400,6,73618400,Negative,-0.3612
02/02/2016,2375,2400,2350,2394,-19,50634000,Neutral,0.0
03/02/2016,2344,2356,2338,2350,-6,62028400,Neutral,0.0
04/02/2016,2400,2444,2350,2369,31,176216000,Neutral,0.0
05/02/2016,2588,2600,2400,2400,188,244064000,Neutral,0.0
09/02/2016,2513,2569,2513,2550,-37,56263200,Neutral,0.0
10/02/2016,2456,2525,2450,2500,-44,56126000,Neutral,0.0
11/02/2016,2500,2506,2456,2456,44,144164400,Neutral,0.0
12/02/2016,2431,2488,2413,2475,-44,136429600,Neutral,0.0
15/02/2016,2450,2456,2431,2450,0,110414800,Neutral,0.0
16/02/2016,2438,2463,2431,2456,-18,90171200,Negative,-0.296
17/02/2016,2425,2450,2419,2431,-6,103568000,Neutral,0.0
18/02/2016,2431,2469,2425,2444,-13,205636800,Neutral,0.0
19/02/2016,2325,2369,2300,2369,-44,381658000,Negative,"-0,3489"
22/02/2016,2350,2369,2306,2306,44,122025200,Neutral,0.0
23/02/2016,2313,2344,2294,2313,0,78939200,Neutral,0.0
24/02/2016,2350,2375,2319,2338,12,76399200,Neutral,0.0
25/02/2016,2331,2363,2313,2350,-19,59981600,Neutral,0.0
26/02/2016,2369,2381,2344,2344,25,59542000,Neutral,0.0
29/02/2016,2388,2388,2344,2369,19,109371200,Positive,"0,8866"
01/03/2016,2363,2388,2344,2369,-6,75571600,Neutral,0.0
02/03/2016,2406,2431,2375,2388,18,125545600,Neutral,0.0
03/03/2016,2425,2444,2400,2425,0,80812000,Neutral,0.0
04/03/2016,2444,2444,2406,2425,19,69759600,Neutral,0.0
07/03/2016,2494,2500,2450,2463,31,176466000,Positive,"0,2753"
08/03/2016,2500,2506,2475,2500,0,145376000,Neutral,0.0
10/03/2016,2525,2525,2450,2450,75,124006000,Neutral,0.0
11/03/2016,2525,2525,2525,2525,0,0,Neutral,0.0
14/03/2016,2525,2525,2525,2525,0,0,Positive,"0,9188"
15/03/2016,2544,2563,2538,2563,-19,57556000,Negative,"-0,2604"
16/03/2016,2544,2550,2500,2550,-6,46800000,Neutral,0.0
17/03/2016,2525,2563,2500,2563,-38,75276400,Neutral,0.0
18/03/2016,2525,2544,2500,2544,-19,110007200,Neutral,0.0
21/03/2016,2538,2550,2525,2525,13,137365600,Neutral,0.0
22/03/2016,2575,2581,2544,2550,25,87624800,Neutral,0.0
23/03/2016,2563,2581,2550,2581,-18,103693600,Neutral,0.0
24/03/2016,2556,2581,2550,2550,6,115484400,Neutral,0.0
28/03/2016,2519,2556,2506,2544,-25,71154000,Negative,-0.2023
29/03/2016,2550,2550,2500,2519,31,90892400,Positive,0.4939
30/03/2016,2588,2588,2513,2525,63,178441600,Neutral,0.0
31/03/2016,2575,2594,2550,2588,-13,103862400,Negative,"-0,353"
01/04/2016,2525,2569,2481,2556,-31,60710400,Neutral,0.0
04/04/2016,2544,2544,2519,2525,19,36848800,Positive,"0,3004"
05/04/2016,2594,2600,2538,2550,44,99461600,Positive,0.4939
06/04/2016,2594,2613,2569,2613,-19,39915200,Neutral,0.0
07/04/2016,2575,2613,2538,2613,-38,70107200,Positive,0.296
08/04/2016,2463,2525,2444,2513,-50,181048000,Positive,0.296
11/04/2016,2463,2463,2463,2463,0,0,Neutral,0.0
12/04/2016,2388,2413,2363,2381,7,153933200,Positive,0.2263
13/04/2016,2388,2388,2388,2388,0,0,Negative,-0.2023
14/04/2016,2388,2388,2388,2388,0,0,Neutral,0.0
15/04/2016,2388,2388,2388,2388,0,0,Positive,"0,7869"
18/04/2016,2388,2388,2388,2388,0,0,Neutral,0.0
19/04/2016,2388,2388,2388,2388,0,0,Neutral,0.0
20/04/2016,2438,2450,2400,2406,32,88110800,Negative,-0.1779
21/04/2016,2469,2481,2438,2438,31,78975600,Positive,0.4939
22/04/2016,2494,2500,2450,2469,25,70598400,Neutral,0.0
25/04/2016,2419,2488,2381,2488,-69,100451600,Neutral,0.0
26/04/2016,2375,2400,2319,2400,-25,143723600,Positive,0.4939
27/04/2016,2406,2413,2344,2350,56,77419600,Neutral,0.0
28/04/2016,2456,2456,2406,2413,43,70421200,Neutral,0.0
29/04/2016,2413,2431,2388,2419,-6,51991600,Neutral,0.0
02/05/2016,2388,2413,2350,2406,-18,39910400,Negative,"-0,406"
03/05/2016,2463,2469,2413,2425,38,87932400,Positive,"0,0403"
04/05/2016,2425,2450,2400,2444,-19,86007600,Negative,"-0,108"
09/05/2016,2325,2406,2288,2400,-75,173752800,Negative,"-0,4961"
10/05/2016,2363,2375,2313,2325,38,96082400,Positive,"0,1964"
11/05/2016,2406,2425,2369,2406,0,61418400,Positive,"0,8823"
12/05/2016,2375,2419,2363,2419,-44,40284400,Negative,"-0,3858"
13/05/2016,2325,2375,2288,2350,-25,86747200,Negative,"-0,1001"
16/05/2016,2256,2288,2244,2275,-19,132095200,Negative,"-0,1402"
17/05/2016,2188,2225,2169,2213,-25,238361200,Negative,"-0,3411"
18/05/2016,2200,2231,2163,2175,25,120478400,Positive,"0,8864"
19/05/2016,2238,2256,2206,2213,25,128139600,Positive,"0,7648"
20/05/2016,2175,2238,2169,2238,-63,102942800,Negative,"-0,2331"
23/05/2016,2213,2225,2188,2194,19,60646400,Positive,"0,8619"
24/05/2016,2213,2231,2206,2219,-6,68519600,Negative,"-0,3619"
25/05/2016,2269,2269,2238,2244,25,65183200,Positive,"0,5405"
26/05/2016,2250,2281,2231,2269,-19,110522400,Negative,"-0,2041"
27/05/2016,2263,2275,2225,2225,38,42332800,Positive,"0,3284"
30/05/2016,2319,2331,2275,2281,38,52332000,Positive,"0,1929"
31/05/2016,2256,2319,2256,2319,-63,121300000,Negative,"-0,4966"
01/06/2016,2300,2319,2250,2250,50,54789600,Positive,0.1779
02/06/2016,2306,2313,2281,2300,6,37745200,Positive,"0,5187"
03/06/2016,2281,2325,2269,2325,-44,41559200,Neutral,0.0
06/06/2016,2319,2325,2281,2288,31,35986000,Neutral,0.0
07/06/2016,2369,2375,2331,2344,25,89779200,Positive,0.1779
08/06/2016,2375,2375,2331,2331,44,47643200,Positive,"0,0113"
09/06/2016,2319,2356,2319,2338,-19,49185600,Neutral,0.0
10/06/2016,2319,2350,2313,2331,-12,38004800,Neutral,0.0
13/06/2016,2263,2306,2256,2300,-37,47977600,Negative,-0.2732
14/06/2016,2244,2263,2225,2256,-12,69002400,Negative,-0.1779
15/06/2016,2250,2275,2231,2238,12,53459200,Neutral,0.0
16/06/2016,2238,2275,2225,2256,-18,70762400,Positive,0.4404
17/06/2016,2238,2250,2219,2250,-12,72084000,Negative,"-0,4291"
20/06/2016,2269,2300,2238,2275,-6,92255600,Neutral,0.0
21/06/2016,2250,2294,2250,2288,-38,48328800,Neutral,0.0
22/06/2016,2250,2275,2250,2263,-13,64551200,Neutral,0.0
23/06/2016,2269,2275,2250,2250,19,39572800,Neutral,0.0
24/06/2016,2263,2288,2213,2288,-25,108756400,Neutral,0.0
27/06/2016,2250,2256,2231,2250,0,30060400,Neutral,0.0
28/06/2016,2363,2375,2231,2250,113,180226800,Neutral,0.0
29/06/2016,2400,2400,2369,2375,25,119147200,Neutral,0.0
30/06/2016,2381,2425,2375,2413,-32,94406800,Negative,"-0,1572"
01/07/2016,2350,2388,2331,2375,-25,60738800,Neutral,0.0
11/07/2016,2425,2438,2350,2350,75,214285200,Neutral,0.0
12/07/2016,2544,2544,2444,2444,100,210138400,Neutral,0.0
13/07/2016,2475,2544,2463,2475,0,180907600,Negative,-0.1779
14/07/2016,2400,2463,2400,2456,-56,156016400,Neutral,0.0
15/07/2016,2419,2431,2400,2406,13,101136000,Positive,"0,1755"
18/07/2016,2419,2425,2394,2400,19,70528800,Positive,"0,8252"
19/07/2016,2525,2525,2400,2413,112,221550000,Neutral,0.0
20/07/2016,2606,2619,2525,2525,81,189806800,Neutral,0.0
21/07/2016,2531,2606,2506,2606,-75,136153200,Negative,"-0,1372"
22/07/2016,2481,2544,2475,2544,-63,63128000,Negative,"-0,3899"
25/07/2016,2481,2506,2456,2488,-7,69858000,Neutral,0.0
26/07/2016,2463,2481,2450,2469,-6,106499600,Neutral,0.0
27/07/2016,2525,2581,2469,2469,56,267820000,Positive,0.2023
28/07/2016,2525,2538,2500,2531,-6,103855200,Positive,0.5574
29/07/2016,2525,2569,2513,2525,0,184920800,Neutral,0.0
01/08/2016,2638,2663,2550,2556,82,259045600,Positive,"0,3716"
02/08/2016,2663,2694,2638,2663,0,248454400,Positive,"0,6516"
03/08/2016,2606,2663,2600,2663,-57,66817200,Negative,"-0,3405"
04/08/2016,2638,2650,2606,2638,0,138364800,Positive,0.4939
05/08/2016,2850,2850,2650,2656,194,271034000,Neutral,0.0
08/08/2016,2913,2919,2863,2875,38,167230400,Positive,"0,8412"
09/08/2016,2950,2988,2913,2913,37,135220000,Neutral,0.0
10/08/2016,2888,2919,2869,2913,-25,68758800,Neutral,0.0
11/08/2016,2794,2875,2763,2863,-69,96170000,Neutral,0.0
12/08/2016,2769,2838,2719,2813,-44,221792400,Positive,0.3818
15/08/2016,2794,2800,2725,2756,38,66988000,Neutral,0.0
16/08/2016,2831,2838,2788,2800,31,101694000,Neutral,0.0
18/08/2016,2856,2863,2831,2838,18,122375200,Neutral,0.0
19/08/2016,2863,2906,2838,2856,7,118537600,Neutral,0.0
22/08/2016,2850,2869,2825,2856,-6,96936400,Neutral,0.0
23/08/2016,2825,2888,2800,2863,-38,106780000,Positive,0.6808
24/08/2016,2838,2881,2831,2838,0,75942800,Neutral,0.0
25/08/2016,2850,2881,2838,2838,12,76602000,Neutral,0.0
26/08/2016,2850,2888,2825,2888,-38,37491600,Neutral,0.0
29/08/2016,2794,2813,2763,2800,-6,109065200,Neutral,0.0
30/08/2016,2819,2819,2763,2775,44,80098800,Positive,"0,043"
31/08/2016,2806,2838,2775,2775,31,89442400,Positive,"0,0425"
01/09/2016,2769,2806,2763,2775,-6,50065600,Neutral,0.0
02/09/2016,2794,2800,2719,2719,75,42616400,Neutral,0.0
05/09/2016,2794,2831,2794,2825,-31,43328000,Negative,"-0,2985"
06/09/2016,2794,2800,2756,2775,19,53300400,Neutral,0.0
07/09/2016,2819,2819,2781,2781,38,63607200,Neutral,0.0
08/09/2016,2800,2813,2781,2794,6,27072800,Positive,0.6369
09/09/2016,2713,2800,2706,2775,-62,99994000,Neutral,0.0
13/09/2016,2669,2706,2625,2669,0,83080000,Neutral,0.0
14/09/2016,2650,2700,2631,2631,19,70232000,Neutral,0.0
15/09/2016,2744,2800,2650,2681,63,87249200,Neutral,0.0
16/09/2016,2769,2813,2750,2775,-6,116464800,Negative,-0.2023
19/09/2016,2806,2825,2781,2794,12,39174800,Positive,0.1779
20/09/2016,2850,2850,2813,2825,25,45393600,Positive,0.34
21/09/2016,2844,2875,2794,2806,38,64057200,Neutral,0.0
22/09/2016,2913,2913,2856,2875,38,84429200,Neutral,0.0
23/09/2016,2875,2925,2869,2875,0,80014800,Neutral,0.0
26/09/2016,2913,2919,2856,2900,13,54502000,Neutral,0.0
27/09/2016,2938,2938,2850,2913,25,132846400,Positive,"0,5222"
28/09/2016,2825,2875,2800,2863,-38,248204400,Negative,"-0,3895"
29/09/2016,2856,2863,2831,2831,25,153378800,Neutral,0.0
30/09/2016,2800,2844,2788,2838,-38,134034000,Neutral,0.0
03/10/2016,2819,2838,2788,2831,-12,72856400,Negative,"-0,3573"
04/10/2016,2800,2825,2794,2819,-19,84598000,Neutral,0.0
05/10/2016,2750,2794,2744,2781,-31,145494400,Negative,"-0,4574"
06/10/2016,2738,2769,2719,2750,-12,103363600,Neutral,0.0
07/10/2016,2725,2738,2706,2706,19,57687200,Neutral,0.0
10/10/2016,2725,2763,2725,2744,-19,56290400,Neutral,0.0
11/10/2016,2713,2750,2700,2731,-18,89322800,Negative,"-0,2816"
12/10/2016,2750,2756,2688,2688,62,58748000,Positive,"0,4289"
13/10/2016,2763,2781,2719,2756,7,74737200,Positive,"0,7225"
14/10/2016,2838,2844,2756,2763,75,94256800,Positive,"0,2293"
17/10/2016,2844,2863,2813,2813,31,67042000,Positive,"0,1478"
18/10/2016,2850,2875,2850,2863,-13,56909600,Negative,"-0,2896"
19/10/2016,2844,2863,2831,2844,0,51456800,Positive,"0,939"
20/10/2016,2825,2856,2825,2850,-25,53644400,Positive,0.1779
21/10/2016,2806,2850,2806,2850,-44,50378800,Neutral,0.0
24/10/2016,2800,2844,2800,2806,-6,63450800,Negative,"-0,2017"
25/10/2016,2794,2825,2788,2806,-12,73782400,Neutral,0.0
26/10/2016,2769,2800,2706,2756,13,141981200,Neutral,0.0
27/10/2016,2831,2844,2769,2769,62,69336400,Negative,-0.1779
28/10/2016,2844,2856,2831,2850,-6,43510800,Neutral,0.0
31/10/2016,2869,2913,2850,2850,19,132730800,Positive,"0,8774"
01/11/2016,2856,2906,2856,2869,-13,74071200,Neutral,0.0
02/11/2016,2875,2888,2856,2856,19,72401600,Neutral,0.0
03/11/2016,2788,2875,2788,2863,-75,91768800,Neutral,0.0
04/11/2016,2775,2819,2738,2750,25,58732400,Neutral,0.0
07/11/2016,2844,2850,2781,2825,19,69898800,Neutral,0.0
08/11/2016,2894,2913,2856,2863,31,82063200,Positive,0.34
09/11/2016,2838,2975,2813,2913,-75,114585600,Negative,-0.2023
10/11/2016,2856,2906,2856,2900,-44,54770400,Negative,"-0,1174"
11/11/2016,2713,2794,2713,2781,-68,200151200,Negative,"-0,4923"
14/11/2016,2581,2688,2513,2675,-94,193930000,Neutral,0.0
15/11/2016,2638,2669,2581,2600,38,84936400,Neutral,0.0
16/11/2016,2706,2738,2650,2650,56,51892800,Neutral,0.0
17/11/2016,2725,2725,2669,2719,6,52244800,Positive,0.4939
18/11/2016,2731,2738,2688,2738,-7,42805200,Neutral,0.0
21/11/2016,2675,2700,2669,2675,0,82676800,Positive,"0,8688"
22/11/2016,2731,2731,2675,2675,56,71874000,Positive,"0,8184"
23/11/2016,2725,2731,2675,2694,31,69157200,Neutral,0.0
24/11/2016,2525,2681,2506,2675,-150,230784000,Neutral,0.0
25/11/2016,2538,2569,2506,2544,-6,112994800,Neutral,0.0
28/11/2016,2538,2544,2506,2538,0,111426000,Neutral,0.0
29/11/2016,2581,2600,2538,2538,43,83037200,Negative,-0.2023
30/11/2016,2625,2656,2600,2600,25,157626400,Positive,"0,5547"
01/12/2016,2625,2675,2625,2625,0,112836400,Positive,"0,4446"
02/12/2016,2675,2694,2625,2663,12,74612800,Positive,"0,7885"
05/12/2016,2663,2681,2650,2650,13,43111200,Positive,"0,1868"
06/12/2016,2663,2706,2644,2700,-37,95774000,Negative,"-0,2154"
07/12/2016,2675,2675,2656,2663,12,42293200,Positive,"0,6329"
08/12/2016,2738,2738,2681,2694,44,62835600,Positive,"0,4136"
09/12/2016,2744,2750,2700,2700,44,64734800,Positive,"0,9522"
13/12/2016,2706,2731,2688,2731,-25,52023200,Neutral,0.0
14/12/2016,2719,2744,2700,2719,0,40252400,Neutral,0.0
15/12/2016,2700,2713,2650,2675,25,55218400,Neutral,0.0
16/12/2016,2688,2713,2688,2700,-12,70044800,Neutral,0.0
19/12/2016,2706,2725,2688,2688,18,23188800,Negative,-0.2023
20/12/2016,2700,2719,2688,2688,12,33521600,Neutral,0.0
21/12/2016,2688,2706,2688,2688,0,46268800,Neutral,0.0
22/12/2016,2688,2706,2675,2688,0,97122800,Neutral,0.0
23/12/2016,2694,2738,2681,2688,6,54570000,Neutral,0.0
27/12/2016,2700,2713,2688,2694,6,38650800,Neutral,0.0
28/12/2016,2788,2788,2719,2738,50,47457600,Positive,0.6249
29/12/2016,2894,2894,2775,2800,94,77951200,Neutral,0.0
30/12/2016,2894,2931,2838,2894,0,136139600,Neutral,0.0
02/01/2017,2894,2894,2894,2894,0,0,Positive,"0,5608"
03/01/2017,2825,2894,2800,2894,-69,50412000,Negative,"-0,4941"
04/01/2017,2838,2838,2781,2825,13,41110400,Positive,"0,5866"
05/01/2017,2813,2831,2788,2800,13,66554400,Positive,"0,9667"
06/01/2017,2844,2856,2819,2838,6,54337600,Positive,"0,6809"
09/01/2017,2819,2856,2806,2856,-37,36349200,Negative,"-0,2116"
10/01/2017,2850,2850,2813,2844,6,24804800,Positive,"0,5073"
11/01/2017,2844,2900,2844,2856,-12,68727200,Negative,"-0,2111"
12/01/2017,2825,2869,2825,2850,-25,29136000,Negative,"-0,292"
13/01/2017,2775,2869,2775,2869,-94,56228800,Negative,"-0,1797"
16/01/2017,2731,2813,2725,2813,-82,77629200,Negative,"-0,2362"
17/01/2017,2731,2756,2725,2725,6,62045200,Positive,"0,1501"
18/01/2017,2763,2781,2738,2750,13,94687200,Positive,"0,2954"
19/01/2017,2763,2794,2750,2775,-12,72744000,Negative,"-0,4358"
20/01/2017,2750,2769,2738,2763,-13,40007200,Negative,"-0,4105"
23/01/2017,2744,2763,2725,2725,19,16690800,Positive,"0,7736"
24/01/2017,2750,2763,2738,2750,0,83274400,Positive,"0,0899"
25/01/2017,2750,2763,2744,2763,-13,76550000,Negative,"-0,4798"
26/01/2017,2725,2756,2725,2738,-13,49446000,Negative,"-0,4782"
27/01/2017,2744,2756,2738,2744,0,24174800,Positive,"0,7435"
30/01/2017,2756,2769,2744,2763,-7,35440400,Negative,"-0,3747"
31/01/2017,2725,2756,2725,2725,0,38055600,Positive,"0,226"
01/02/2017,2744,2756,2731,2744,0,117245600,Positive,"0,2501"
02/02/2017,2750,2763,2738,2744,6,79610000,Positive,"0,8307"
03/02/2017,2769,2775,2750,2769,0,111316000,Positive,"0,2891"
06/02/2017,2844,2850,2788,2788,56,198014400,Positive,"0,413"
07/02/2017,2850,2863,2831,2844,6,117718800,Positive,"0,7149"
08/02/2017,2806,2838,2794,2838,-32,109655200,Negative,"-0,3116"
09/02/2017,2869,2894,2850,2850,19,97844000,Positive,"0,8864"
10/02/2017,2850,2900,2838,2900,-50,96540400,Negative,"-0,1364"
13/02/2017,2863,2900,2856,2894,-31,81397200,Negative,"-0,1194"
14/02/2017,2856,2869,2838,2863,-7,79745200,Negative,"-0,4148"
15/02/2017,2856,2856,2856,2856,0,0,Positive,"0,7002"
16/02/2017,2800,2838,2725,2825,-25,207778000,Negative,"-0,3179"
17/02/2017,2769,2800,2750,2800,-31,103224000,Negative,"-0,1326"
20/02/2017,2819,2819,2775,2800,19,72190000,Positive,"0,8742"
21/02/2017,2788,2825,2775,2825,-37,50008400,Negative,"-0,4433"
22/02/2017,2825,2825,2775,2813,12,106237200,Positive,"0,352"
23/02/2017,2788,2819,2788,2788,0,43852800,Positive,"0,1621"
24/02/2017,2775,2819,2775,2819,-44,59158000,Negative,"-0,2288"
27/02/2017,2794,2806,2794,2794,0,30397600,Positive,"0,9419"
28/02/2017,2825,2850,2800,2825,0,43444400,Positive,"0,1587"
01/03/2017,2838,2850,2806,2850,-12,91156400,Negative,"-0,2636"
02/03/2017,2831,2863,2831,2844,-13,57482800,Negative,"-0,2356"
03/03/2017,2838,2844,2800,2813,25,29331600,Positive,"0,9962"
06/03/2017,2825,2844,2806,2838,-13,42578400,Negative,"-0,4125"
07/03/2017,2831,2838,2800,2800,31,86823200,Positive,"0,1997"
08/03/2017,2831,2850,2831,2844,-13,33371200,Negative,"-0,2286"
09/03/2017,2844,2844,2813,2844,0,14298400,Positive,"0,1795"
10/03/2017,2850,2850,2831,2850,0,22744800,Positive,"0,68"
13/03/2017,2850,2850,2800,2800,50,45914400,Positive,"0,7662"
14/03/2017,2856,2863,2825,2825,31,32416800,Positive,"0,4025"
15/03/2017,2863,2894,2844,2875,-12,38783600,Negative,"-0,2008"
16/03/2017,2894,2913,2881,2894,0,124136800,Positive,"0,6435"
17/03/2017,2906,2925,2888,2913,-7,115811200,Negative,"-0,4803"
20/03/2017,2944,2975,2906,2931,13,84118000,Positive,"0,8163"
21/03/2017,2950,2975,2938,2963,-13,98651200,Negative,"-0,4156"
22/03/2017,2944,2956,2869,2888,56,137866400,Positive,"0,5674"
23/03/2017,2975,3006,2963,2963,12,164951600,Positive,"0,2969"
24/03/2017,2975,2994,2938,2994,-19,101622400,Negative,"-0,1649"
27/03/2017,2925,2963,2925,2925,0,43376800,Positive,"0,102"
29/03/2017,2944,2975,2919,2975,-31,55658000,Negative,"-0,4701"
30/03/2017,2944,2963,2906,2944,0,32161600,Positive,"0,9351"
31/03/2017,2925,2944,2925,2938,-13,63985600,Negative,"-0,1514"
03/04/2017,2938,2963,2900,2950,-12,58964400,Negative,"-0,1358"
04/04/2017,2938,2988,2913,2913,25,77408800,Positive,"0,8738"
05/04/2017,2938,2938,2938,2938,0,0,Positive,"0,1573"
06/04/2017,3106,3106,2956,2975,131,87415600,Positive,"0,2859"
07/04/2017,3050,3106,3050,3075,-25,79835600,Negative,"-0,2832"
10/04/2017,3013,3069,2988,3056,-43,36636800,Negative,"-0,2676"
11/04/2017,2938,3000,2925,3000,-62,43113200,Negative,"-0,1981"
12/04/2017,2925,2950,2919,2919,6,32561600,Positive,"0,0367"
13/04/2017,2913,2963,2875,2950,-37,56194400,Negative,"-0,4723"
17/04/2017,2906,2925,2881,2925,-19,19153200,Negative,"-0,1562"
18/04/2017,2938,2963,2906,2925,13,89368000,Positive,"0,9394"
19/04/2017,2938,2938,2938,2938,0,0,Positive,"0,9214"
20/04/2017,2881,2938,2863,2925,-44,81478400,Negative,"-0,4163"
21/04/2017,2850,2919,2850,2894,-44,38329600,Negative,"-0,3264"
25/04/2017,2888,2925,2869,2894,-6,149208000,Negative,"-0,4604"
26/04/2017,2956,3069,2925,2925,31,319850400,Neutral,0.0
27/04/2017,2931,2963,2925,2925,6,106382000,Positive,0.2263
28/04/2017,2925,2938,2913,2919,6,83747600,Neutral,0.0
02/05/2017,2919,2931,2919,2925,-6,83054400,Negative,-0.2263
03/05/2017,2894,2913,2875,2913,-19,99818800,Negative,-0.1779
04/05/2017,2925,2956,2906,2906,19,134070000,Positive,"0,6951"
05/05/2017,2994,3031,2938,2938,56,146848400,Neutral,0.0
08/05/2017,3013,3069,3013,3025,-12,150575200,Neutral,0.0
09/05/2017,3000,3038,3000,3013,-13,60982800,Neutral,0.0
10/05/2017,3006,3025,2981,3025,-19,78420400,Neutral,0.0
12/05/2017,3000,3044,2988,3044,-44,97264400,Neutral,0.0
15/05/2017,3031,3031,2988,3025,6,45706000,Neutral,0.0
16/05/2017,2994,3038,2988,3031,-37,75918000,Neutral,0.0
17/05/2017,3000,3013,2950,2994,6,84887200,Neutral,0.0
18/05/2017,3038,3038,2963,3000,38,35564400,Positive,0.1779
19/05/2017,3225,3319,2994,3038,187,113093200,Neutral,0.0
22/05/2017,3131,3325,3100,3300,-169,102829200,Neutral,0.0
23/05/2017,3063,3144,3025,3131,-68,73616400,Neutral,0.0
24/05/2017,3100,3100,3000,3013,87,50502800,Neutral,0.0
26/05/2017,3038,3125,3025,3119,-81,57578000,Neutral,0.0
29/05/2017,3088,3100,3038,3075,13,46570000,Neutral,0.0
30/05/2017,3106,3119,3063,3063,43,40218400,Positive,0.1779
31/05/2017,3150,3150,3088,3125,25,85243600,Positive,"0,5234"
01/06/2017,3150,3150,3150,3150,0,0,Positive,"0,6475"
02/06/2017,3150,3213,3125,3213,-63,59829200,Negative,"-0,4607"
05/06/2017,3169,3194,3144,3150,19,47045600,Positive,"0,7915"
06/06/2017,3125,3181,3094,3144,-19,28721200,Negative,"-0,1058"
07/06/2017,3100,3125,3088,3088,12,49372000,Positive,"0,6737"
08/06/2017,3081,3100,3050,3088,-7,71202800,Negative,"-0,3444"
09/06/2017,3056,3113,3050,3075,-19,32254000,Negative,"-0,4664"
12/06/2017,3056,3081,3056,3069,-13,25720400,Neutral,0.0
13/06/2017,3063,3106,3038,3038,25,33952400,Neutral,0.0
14/06/2017,3125,3138,3075,3081,44,47202400,Neutral,0.0
15/06/2017,3125,3188,3113,3125,0,93786800,Neutral,0.0
16/06/2017,3119,3125,3081,3113,6,87512000,Neutral,0.0
19/06/2017,3119,3131,3100,3119,0,30677600,Neutral,0.0
20/06/2017,3131,3131,3069,3113,18,69688000,Neutral,0.0
21/06/2017,3175,3175,3106,3113,62,194634400,Neutral,0.0
22/06/2017,3188,3188,3138,3175,13,140644400,Neutral,0.0
23/06/2017,3188,3188,3188,3188,0,0,Neutral,0.0
26/06/2017,3188,3188,3188,3188,0,0,Positive,"0,4599"
27/06/2017,3188,3188,3188,3188,0,0,Positive,"0,78"
28/06/2017,3188,3188,3188,3188,0,0,Positive,"0,7332"
29/06/2017,3188,3188,3188,3188,0,0,Positive,"0,0407"
30/06/2017,3188,3188,3188,3188,0,0,Positive,"0,1093"
03/07/2017,3375,3375,3169,3194,181,116340400,Neutral,0.0
04/07/2017,3375,3375,3300,3331,44,65585600,Neutral,0.0
05/07/2017,3331,3369,3306,3369,-38,156807200,Neutral,0.0
06/07/2017,3331,3363,3325,3331,0,68512000,Neutral,0.0
07/07/2017,3313,3344,3275,3275,38,94396000,Neutral,0.0
10/07/2017,3275,3325,3250,3250,25,44828000,Positive,"0,2405"
11/07/2017,3244,3263,3219,3250,-6,49422400,Negative,"-0,4611"
12/07/2017,3306,3313,3213,3213,93,33112400,Positive,"0,8796"
13/07/2017,3350,3350,3263,3325,25,102872000,Positive,"0,6484"
14/07/2017,3388,3388,3300,3363,25,23547200,Positive,"0,7604"
17/07/2017,3394,3394,3363,3388,6,28083200,Positive,"0,8925"
18/07/2017,3381,3381,3356,3375,6,17110400,Positive,"0,24"
19/07/2017,3331,3394,3313,3394,-63,47982400,Negative,"-0,364"
20/07/2017,3375,3375,3325,3331,44,31556800,Positive,"0,9577"
21/07/2017,3263,3375,3263,3331,-68,62956800,Neutral,0.0
24/07/2017,3319,3319,3250,3256,63,68629600,Neutral,0.0
25/07/2017,3338,3338,3275,3275,63,56757200,Positive,0.1779
26/07/2017,3338,3363,3300,3300,38,114075600,Neutral,0.0
27/07/2017,3344,3363,3325,3338,6,74731600,Neutral,0.0
28/07/2017,3344,3363,3306,3363,-19,87392800,Neutral,0.0
31/07/2017,3413,3413,3325,3350,63,85417600,Neutral,0.0
01/08/2017,3350,3419,3350,3419,-69,29979200,Negative,-0.2732
02/08/2017,3319,3375,3313,3319,0,65299600,Negative,-0.2732
03/08/2017,3281,3325,3275,3300,-19,75375200,Neutral,0.0
04/08/2017,3269,3331,3263,3263,6,62769600,Neutral,0.0
07/08/2017,3294,3306,3263,3263,31,71766800,Neutral,0.0
08/08/2017,3356,3356,3288,3294,62,58065600,Neutral,0.0
09/08/2017,3350,3375,3313,3363,-13,49458800,Neutral,0.0
10/08/2017,3331,3375,3319,3375,-44,41486400,Neutral,0.0
11/08/2017,3300,3325,3288,3313,-13,111049200,Neutral,0.0
14/08/2017,3313,3325,3300,3300,13,77951600,Neutral,0.0
15/08/2017,3325,3331,3319,3331,-6,47208800,Negative,"-0,2147"
16/08/2017,3331,3331,3313,3331,0,40337200,Neutral,0.0
17/08/2017,3331,3331,3331,3331,0,0,Negative,-0.1027
18/08/2017,3275,3300,3269,3300,-25,143414400,Neutral,0.0
21/08/2017,3300,3313,3263,3263,37,56732800,Positive,"0,2509"
22/08/2017,3313,3325,3313,3325,-12,37080400,Neutral,0.0
23/08/2017,3319,3344,3300,3338,-19,46171200,Neutral,0.0
24/08/2017,3300,3325,3300,3325,-25,84711600,Neutral,0.0
25/08/2017,3294,3338,3294,3338,-44,45026400,Neutral,0.0
28/08/2017,3306,3319,3300,3313,-7,15407600,Neutral,0.0
29/08/2017,3275,3306,3275,3294,-19,83386400,Neutral,0.0
30/08/2017,3275,3294,3269,3275,0,48228400,Positive,"0,052"
31/08/2017,3275,3294,3269,3269,6,69100800,Positive,"0,6516"
01/09/2017,3275,3275,3275,3275,0,0,Positive,"0,001"
04/09/2017,3263,3281,3244,3263,0,69268400,Positive,"0,7869"
05/09/2017,3269,3269,3219,3250,19,53423200,Positive,"0,4511"
06/09/2017,3238,3256,3200,3225,13,126368400,Positive,"0,7415"
07/09/2017,3256,3263,3225,3263,-7,45544400,Negative,"-0,475"
08/09/2017,3319,3331,3250,3269,50,92788000,Positive,"0,2741"
11/09/2017,3300,3325,3300,3319,-19,51046400,Negative,-0.2732
12/09/2017,3300,3331,3294,3325,-25,51482000,Neutral,0.0
13/09/2017,3288,3350,3275,3350,-62,22269800,Positive,0.1779
14/09/2017,3275,3325,3275,3313,-38,32387000,Negative,"-0,3705"
15/09/2017,3313,3338,3263,3275,38,96577000,Positive,"0,0029"
18/09/2017,3288,3313,3250,3275,13,31203000,Neutral,0.0
19/09/2017,3300,3313,3263,3300,0,65627600,Positive,0.2023
20/09/2017,3300,3313,3275,3288,12,152308200,Neutral,0.0
21/09/2017,3300,3300,3300,3300,0,0,Positive,"0,5447"
22/09/2017,3300,3325,3275,3300,0,88331600,Positive,0.3818
25/09/2017,3288,3325,3275,3300,-12,55045800,Negative,"-0,2051"
26/09/2017,3275,3300,3275,3300,-25,94085400,Negative,"-0,3379"
27/09/2017,3300,3300,3263,3288,12,121814200,Positive,"0,2344"
28/09/2017,3288,3313,3288,3300,-12,56049600,Neutral,0.0
29/09/2017,3363,3388,3288,3288,75,175719200,Negative,-0.2732
02/10/2017,3350,3375,3313,3363,-13,41590800,Neutral,0.0
03/10/2017,3350,3375,3325,3350,0,59653400,Positive,"0,8334"
04/10/2017,3325,3363,3325,3363,-38,43641800,Negative,"-0,2998"
05/10/2017,3300,3350,3288,3338,-38,77918000,Negative,"-0,1515"
06/10/2017,3300,3313,3288,3300,0,22471200,Neutral,0.0
09/10/2017,3300,3325,3288,3325,-25,21028600,Positive,0.4019
10/10/2017,3350,3363,3300,3325,25,53161200,Negative,-0.2732
11/10/2017,3363,3388,3338,3363,0,117588400,Positive,"0,3941"
12/10/2017,3413,3438,3338,3375,38,167578400,Positive,"0,8382"
13/10/2017,3388,3500,3388,3425,-37,98661000,Negative,"-0,3918"
16/10/2017,3463,3563,3438,3438,25,177292000,Positive,"0,3211"
17/10/2017,3513,3538,3475,3538,-25,112955000,Negative,"-0,4689"
18/10/2017,3538,3550,3513,3550,-12,152454400,Negative,"-0,2702"
19/10/2017,3488,3538,3463,3538,-50,78878400,Negative,"-0,294"
20/10/2017,3550,3563,3475,3488,62,55557200,Positive,"0,808"
23/10/2017,3475,3550,3450,3538,-63,65908600,Positive,0.2263
24/10/2017,3413,3500,3413,3450,-37,44982200,Negative,-0.1779
25/10/2017,3500,3525,3475,3475,25,166683400,Negative,-0.2023
26/10/2017,3513,3550,3488,3525,-12,91155200,Negative,"-0,1605"
27/10/2017,3475,3563,3475,3500,-25,63364400,Negative,"-0,4697"
30/10/2017,3538,3563,3488,3550,-12,107043000,Negative,"-0,4121"
31/10/2017,3525,3575,3500,3563,-38,78930400,Negative,"-0,3187"
01/11/2017,3550,3550,3513,3550,0,43310400,Positive,"0,1497"
02/11/2017,3638,3713,3563,3575,63,68625800,Neutral,0.0
03/11/2017,3625,3688,3563,3675,-50,78730200,Neutral,0.0
06/11/2017,3613,3675,3575,3575,38,59551800,Neutral,0.0
07/11/2017,3563,3638,3538,3613,-50,56480400,Neutral,0.0
08/11/2017,3588,3600,3550,3575,13,80597600,Neutral,0.0
09/11/2017,3538,3600,3538,3588,-50,170971800,Neutral,0.0
10/11/2017,3525,3563,3513,3550,-25,84111200,Negative,-0.3612
13/11/2017,3525,3550,3475,3550,-25,33709000,Negative,"-0,3671"
14/11/2017,3475,3550,3475,3500,-25,59334000,Negative,"-0,4501"
15/11/2017,3488,3525,3463,3525,-37,81461200,Negative,"-0,2081"
16/11/2017,3550,3563,3463,3463,87,79021400,Positive,"0,2637"
17/11/2017,3663,3700,3563,3588,75,96578200,Positive,"0,7655"
20/11/2017,3713,3738,3650,3688,25,53410000,Positive,"0,9705"
21/11/2017,3700,3725,3663,3725,-25,191716800,Negative,"-0,3641"
22/11/2017,3688,3800,3688,3750,-62,72659600,Negative,"-0,4123"
23/11/2017,3725,3763,3688,3763,-38,55739600,Negative,"-0,1897"
24/11/2017,3725,3750,3688,3750,-25,36058400,Neutral,0.0
27/11/2017,3713,3738,3688,3725,-12,122810200,Neutral,0.0
28/11/2017,3713,3725,3700,3700,13,68486600,Positive,0.3818
29/11/2017,3700,3738,3700,3738,-38,139273800,Neutral,0.0
30/11/2017,3700,3800,3688,3700,0,167540000,Positive,"0,1015"
01/12/2017,3700,3700,3700,3700,0,0,Positive,"0,2638"
04/12/2017,3725,3750,3700,3750,-25,73258000,Neutral,0.0
05/12/2017,3738,3763,3713,3738,0,65673400,Neutral,0.0
06/12/2017,3738,3763,3725,3750,-12,47704000,Negative,"-0,1538"
07/12/2017,3675,3738,3675,3725,-50,50580000,Negative,"-0,1212"
08/12/2017,3738,3763,3688,3750,-12,33166400,Negative,"-0,4015"
11/12/2017,3738,3775,3725,3763,-25,17030400,Negative,"-0,2323"
12/12/2017,3725,3775,3700,3775,-50,51088800,Negative,"-0,259"
13/12/2017,3738,3750,3700,3700,38,54077800,Positive,"0,8076"
14/12/2017,3738,3775,3713,3750,-12,122524400,Negative,"-0,3442"
15/12/2017,3713,3738,3650,3700,13,94872200,Positive,"0,062"
18/12/2017,3750,3750,3650,3663,87,33166000,Positive,"0,4977"
19/12/2017,3738,3763,3675,3688,50,70926400,Positive,"0,7464"
20/12/2017,3725,3763,3688,3763,-38,79075800,Negative,"-0,3315"
21/12/2017,3813,3850,3750,3775,38,88489000,Negative,-0.2732
22/12/2017,3838,3850,3775,3813,25,158513400,Neutral,0.0
25/12/2017,3838,3838,3838,3838,0,0,Positive,"0,648"
26/12/2017,3838,3838,3838,3838,0,0,Neutral,0.0
27/12/2017,4000,4025,3838,3838,162,53968200,Neutral,0.0
28/12/2017,3975,4050,3925,3988,-13,251049600,Negative,-0.2732
29/12/2017,4000,4038,3900,4025,-25,78314600,Positive,0.25
01/01/2018,4000,4000,4000,4000,0,0,Neutral,0.0
02/01/2018,3925,4025,3913,3988,-63,59351600,Neutral,0.0
03/01/2018,3850,3925,3825,3925,-75,84278000,Neutral,0.0
04/01/2018,3913,3913,3863,3875,38,90123000,Neutral,0.0
05/01/2018,3913,3925,3863,3863,50,75378600,Neutral,0.0
08/01/2018,3963,3975,3913,3938,25,73784000,Positive,"0,6802"
09/01/2018,3950,4000,3888,3988,-38,67352000,Negative,"-0,3818"
10/01/2018,3950,3963,3900,3963,-13,68746400,Negative,"-0,1507"
11/01/2018,4038,4038,3963,3963,75,89346200,Positive,"0,5483"
12/01/2018,4050,4125,4000,4038,12,84306400,Positive,"0,0393"
15/01/2018,4100,4100,4025,4075,25,38412200,Positive,0.2732
16/01/2018,4113,4150,4075,4075,38,46720000,Neutral,0.0
17/01/2018,4050,4113,4013,4113,-63,56945400,Negative,-0.2732
18/01/2018,4063,4088,4025,4075,-12,53685800,Neutral,0.0
19/01/2018,4038,4088,4025,4088,-50,50158600,Neutral,0.0
22/01/2018,4038,4075,4025,4075,-37,91243800,Neutral,0.0
23/01/2018,4088,4088,4038,4088,0,111192600,Positive,"0,0107"
24/01/2018,4125,4125,4075,4100,25,84633200,Positive,"0,5921"
25/01/2018,4075,4138,4038,4125,-50,65155800,Negative,"-0,2499"
26/01/2018,4100,4125,4063,4100,0,69599800,Positive,"0,7228"
29/01/2018,4088,4125,3950,4113,-25,101413600,Negative,"-0,462"
30/01/2018,4025,4050,3988,4038,-13,102154200,Negative,"-0,3624"
31/01/2018,4075,4088,3975,3988,87,79788400,Positive,"0,3454"
01/02/2018,4100,4125,4063,4100,0,72274400,Positive,"0,6442"
02/02/2018,4063,4113,4063,4100,-37,60042800,Negative,"-0,2467"
05/02/2018,4063,4075,3988,4025,38,63620600,Positive,"0,7082"
06/02/2018,4013,4050,3963,4000,13,92415600,Positive,"0,2487"
07/02/2018,4063,4075,4038,4050,13,57427400,Positive,"0,0188"
08/02/2018,4088,4125,4025,4100,-12,79067200,Negative,"-0,2175"
09/02/2018,4113,4113,4025,4038,75,211953600,Positive,"0,799"
12/02/2018,4100,4125,4038,4113,-13,72517000,Negative,"-0,162"
13/02/2018,4138,4150,4100,4100,38,75870600,Positive,"0,17"
14/02/2018,4150,4163,4113,4150,0,26730800,Positive,"0,7638"
15/02/2018,4150,4188,4075,4188,-38,65557000,Negative,"-0,1322"
16/02/2018,4150,4150,4150,4150,0,0,Positive,"0,9898"
19/02/2018,4238,4238,4138,4175,63,49342200,Positive,"0,5798"
20/02/2018,4525,4525,4213,4263,262,79298400,Neutral,0.0
21/02/2018,4400,4463,4375,4450,-50,83845600,Neutral,0.0
22/02/2018,4313,4438,4288,4438,-125,39301400,Neutral,0.0
23/02/2018,4275,4350,4250,4288,-13,62711800,Negative,"-0,3106"
26/02/2018,4150,4300,4150,4300,-150,66541400,Negative,"-0,1209"
27/02/2018,4213,4263,4163,4213,0,92994400,Positive,"0,4229"
28/02/2018,4150,4238,4150,4238,-88,81356600,Negative,"-0,3884"
01/03/2018,4188,4225,4163,4200,-12,50682200,Negative,"-0,2669"
02/03/2018,4238,4238,4113,4163,75,49761400,Positive,"0,1178"
05/03/2018,4113,4213,4100,4188,-75,44376600,Negative,"-0,342"
06/03/2018,4025,4150,4000,4138,-113,77337000,Negative,"-0,185"
07/03/2018,3963,4063,3850,4013,-50,116997600,Negative,"-0,1427"
08/03/2018,4050,4088,4000,4000,50,86635600,Positive,"0,7269"
09/03/2018,4050,4088,4000,4025,25,46391000,Positive,"0,5725"
12/03/2018,4163,4163,4075,4100,63,78310600,Neutral,0.0
13/03/2018,4088,4138,4025,4113,-25,79622600,Negative,-0.2732
14/03/2018,4100,4113,3988,4113,-13,41997000,Neutral,0.0
15/03/2018,4000,4088,4000,4088,-88,66507000,Positive,0.4588
16/03/2018,3963,3975,3850,3950,13,155572000,Negative,-0.34
19/03/2018,4038,4063,3963,4013,25,95158400,Neutral,0.0
20/03/2018,4050,4075,3925,3975,75,77864800,Positive,"0,73"
21/03/2018,4100,4113,4050,4100,0,113297400,Positive,"0,6952"
22/03/2018,4000,4125,3975,4125,-125,183372000,Negative,"-0,139"
23/03/2018,4025,4025,3850,3900,125,90662600,Positive,"0,4995"
26/03/2018,4038,4038,3925,3925,113,42673400,Positive,"0,965"
27/03/2018,4000,4075,3975,4063,-63,55450200,Negative,"-0,1899"
28/03/2018,3900,3988,3863,3975,-75,76203200,Negative,"-0,4762"
29/03/2018,3838,3838,3763,3825,13,78477600,Positive,0.3182
30/03/2018,3838,3838,3838,3838,0,0,Neutral,0.0
02/04/2018,3913,3913,3788,3788,125,31435200,Neutral,0.0
03/04/2018,3900,3900,3838,3863,37,47967200,Neutral,0.0
04/04/2018,3800,3913,3775,3913,-113,38287200,Neutral,0.0
05/04/2018,3825,3875,3763,3875,-50,54709000,Negative,"-0,1174"
06/04/2018,3775,3813,3750,3775,0,45831200,Positive,"0,6401"
09/04/2018,3788,3825,3750,3825,-37,32505800,Negative,"-0,1909"
10/04/2018,3938,3938,3775,3775,163,87487000,Positive,"0,4357"
11/04/2018,4025,4038,3963,3975,50,58578400,Positive,"0,9782"
12/04/2018,4013,4013,3925,4000,13,56053600,Positive,"0,4551"
13/04/2018,4013,4050,3963,4050,-37,33896200,Negative,"-0,4819"
16/04/2018,4013,4013,4013,4013,0,0,Positive,"0,5657"
17/04/2018,4013,4013,4013,4013,0,0,Positive,"0,1065"
18/04/2018,4025,4025,3950,3975,50,28595200,Positive,"0,4754"
19/04/2018,4025,4025,4025,4025,0,0,Positive,"0,9842"
20/04/2018,4025,4025,4025,4025,0,0,Positive,"0,3697"
23/04/2018,4000,4000,3925,3938,62,62793000,Positive,"0,0243"
24/04/2018,3863,4000,3863,4000,-137,49193400,Negative,"-0,1887"
25/04/2018,3863,3863,3863,3863,0,0,Positive,"0,6379"
26/04/2018,3863,3863,3863,3863,0,0,Positive,"0,1784"
27/04/2018,3863,3863,3863,3863,0,0,Neutral,0.0
30/04/2018,3563,3575,3438,3500,63,94666400,Neutral,0.0
01/05/2018,3563,3563,3563,3563,0,0,Positive,"0,5127"
02/05/2018,3600,3613,3488,3563,37,53590000,Neutral,0.0
03/05/2018,3425,3588,3425,3575,-150,104380400,Neutral,0.0
04/05/2018,3313,3450,3300,3425,-112,54995600,Negative,"-0,1431"
07/05/2018,3400,3438,3300,3300,100,66820800,Neutral,0.0
08/05/2018,3400,3413,3338,3400,0,106457400,Neutral,0.0
09/05/2018,3588,3588,3363,3363,225,111977600,Neutral,0.0
10/05/2018,3588,3588,3588,3588,0,0,Positive,"0,2867"
11/05/2018,3600,3738,3575,3625,-25,103564000,Neutral,0.0
14/05/2018,3600,3650,3475,3650,-50,73256600,Negative,"-0,1056"
15/05/2018,3425,3600,3400,3500,-75,117942000,Negative,"-0,223"
16/05/2018,3425,3438,3300,3350,75,171743000,Positive,1
17/05/2018,3350,3500,3350,3475,-125,108035800,Negative,"-0,2335"
18/05/2018,3400,3450,3325,3388,12,73179600,Positive,"0,9237"
21/05/2018,3338,3388,3300,3363,-25,93035200,Negative,"-0,1101"
22/05/2018,3263,3388,3263,3375,-112,95244600,Neutral,0.0
23/05/2018,3388,3438,3300,3300,88,98477800,Negative,-0.25
24/05/2018,3500,3538,3425,3500,0,105512200,Neutral,0.0
25/05/2018,3500,3538,3475,3525,-25,87283000,Neutral,0.0
28/05/2018,3688,3713,3550,3575,113,129253400,Positive,"0,6449"
29/05/2018,3688,3688,3688,3688,0,0,Positive,"0,1568"
30/05/2018,3625,3813,3575,3613,12,170628800,Positive,"0,4084"
31/05/2018,3525,3700,3513,3700,-175,211020800,Negative,"-0,1039"
01/06/2018,3525,3525,3525,3525,0,0,Positive,"0,3587"
04/06/2018,3688,3713,3550,3550,138,80221000,Neutral,0.0
05/06/2018,3675,3725,3638,3725,-50,73520200,Negative,-0.3818
06/06/2018,3663,3688,3650,3650,13,72158600,Neutral,0.0
07/06/2018,3688,3700,3663,3688,0,49787600,Neutral,0.0
08/06/2018,3475,3700,3475,3700,-225,134418800,Negative,"-0,4996"
11/06/2018,3475,3475,3475,3475,0,0,Positive,"0,5326"
12/06/2018,3475,3475,3475,3475,0,0,Positive,"0,0136"
13/06/2018,3475,3475,3475,3475,0,0,Positive,"0,7756"
14/06/2018,3475,3475,3475,3475,0,0,Positive,"0,9116"
15/06/2018,3475,3475,3475,3475,0,0,Positive,"0,4675"
18/06/2018,3475,3475,3475,3475,0,0,Positive,"0,9138"
19/06/2018,3475,3475,3475,3475,0,0,Positive,"0,8369"
20/06/2018,3350,3425,3250,3425,-75,170142400,Negative,"-0,2753"
21/06/2018,3350,3388,3288,3350,0,109648600,Positive,"0,0036"
22/06/2018,3350,3363,3300,3350,0,90954000,Positive,"0,7684"
25/06/2018,3350,3388,3288,3375,-25,59331600,Negative,"-0,3894"
26/06/2018,3313,3375,3288,3288,25,55935600,Positive,"0,3283"
27/06/2018,3300,3350,3300,3325,-25,51148600,Negative,"-0,3519"
28/06/2018,3250,3363,3213,3363,-113,109565000,Negative,-0.4767
29/06/2018,3425,3425,3300,3375,50,82868000,Positive,0.5267
02/07/2018,3263,3488,3263,3488,-225,55579800,Neutral,0.0
03/07/2018,3163,3288,3163,3238,-75,74286400,Neutral,0.0
04/07/2018,3300,3313,3138,3200,100,54066400,Positive,"0,5687"
05/07/2018,3263,3300,3175,3250,13,49814600,Negative,-0.1779
06/07/2018,3150,3238,3150,3200,-50,51696400,Negative,-0.0516
09/07/2018,3213,3263,3150,3175,38,111683800,Neutral,0.0
10/07/2018,3225,3288,3188,3250,-25,87662000,Positive,0.1779
11/07/2018,3175,3188,3125,3150,25,71600600,Neutral,0.0
12/07/2018,3225,3225,3150,3150,75,69482600,Neutral,0.0
13/07/2018,3300,3325,3213,3213,87,71123600,Positive,0.5106
16/07/2018,3275,3313,3188,3275,0,57879600,Positive,"0,5906"
17/07/2018,3163,3238,3150,3225,-62,84860000,Negative,"-0,2559"
18/07/2018,3200,3213,3150,3163,37,46293000,Positive,"0,8546"
19/07/2018,3188,3263,3188,3213,-25,69942000,Negative,"-0,4764"
20/07/2018,3175,3225,3138,3213,-38,101994800,Neutral,0.0
23/07/2018,3200,3288,3188,3200,0,80140200,Neutral,0.0
24/07/2018,3263,3263,3200,3250,13,38980400,Positive,0.5106
25/07/2018,3238,3275,3225,3275,-37,62149400,Positive,0.3818
26/07/2018,3275,3275,3238,3250,25,57947800,Negative,-0.2263
27/07/2018,3288,3288,3250,3288,0,35688800,Neutral,0.0
30/07/2018,3363,3363,3275,3288,75,54608200,Neutral,0.0
31/07/2018,3325,3363,3288,3363,-38,66929400,Negative,"-0,1669"
01/08/2018,3500,3500,3338,3350,150,110824000,Positive,"0,9719"
02/08/2018,3525,3588,3463,3500,25,61392400,Positive,"0,6139"
03/08/2018,3600,3613,3500,3500,100,63550400,Positive,"0,2002"
06/08/2018,3650,3713,3600,3613,37,102478600,Positive,"0,9216"
07/08/2018,3600,3713,3600,3650,-50,102967800,Negative,"-0,2324"
08/08/2018,3663,3663,3550,3613,50,48967400,Positive,"0,4369"
09/08/2018,3638,3675,3600,3600,38,28914800,Positive,"0,3997"
10/08/2018,3675,3713,3650,3663,12,36267800,Positive,"0,0414"
13/08/2018,3463,3625,3425,3600,-137,82658400,Negative,-0.1779
14/08/2018,3363,3450,3350,3438,-75,122915000,Neutral,0.0
15/08/2018,3400,3413,3263,3375,25,82042800,Negative,-0.2263
16/08/2018,3350,3388,3300,3375,-25,42463600,Negative,-0.1779
17/08/2018,3350,3350,3350,3350,0,0,Positive,"0,9217"
20/08/2018,3363,3475,3350,3475,-112,81139200,Neutral,0.0
21/08/2018,3350,3388,3338,3375,-25,62399200,Neutral,0.0
22/08/2018,3350,3350,3350,3350,0,0,Positive,"0,0028"
23/08/2018,3425,3425,3350,3400,25,98059800,Positive,"0,7081"
24/08/2018,3388,3425,3375,3400,-12,75683200,Negative,"-0,472"
27/08/2018,3488,3488,3388,3413,75,84503200,Positive,"0,5752"
28/08/2018,3500,3513,3450,3500,0,80591200,Positive,"0,9339"
29/08/2018,3500,3513,3463,3488,12,55272600,Neutral,0.0
30/08/2018,3425,3513,3400,3500,-75,52753200,Negative,-0.2732
31/08/2018,3450,3450,3338,3350,100,110408200,Neutral,0.0
03/09/2018,3350,3450,3350,3450,-100,55590200,Negative,-0.2732
04/09/2018,3288,3375,3225,3363,-75,59803000,Neutral,0.0
05/09/2018,3163,3263,3100,3250,-87,83838600,Neutral,0.0
06/09/2018,3275,3275,3100,3100,175,96306200,Neutral,0.0
07/09/2018,3313,3325,3225,3250,63,75525400,Neutral,0.0
10/09/2018,3288,3300,3213,3250,38,37301800,Negative,-0.2732
11/09/2018,3288,3288,3288,3288,0,0,Neutral,0.0
12/09/2018,3188,3313,3188,3288,-100,46357000,Neutral,0.0
13/09/2018,3288,3313,3225,3238,50,36668600,Positive,0.5267
14/09/2018,3375,3375,3300,3338,37,30656000,Neutral,0.0
17/09/2018,3225,3338,3213,3325,-100,88368200,Negative,-0.2732
18/09/2018,3188,3263,3163,3225,-37,101172800,Neutral,0.0
19/09/2018,3200,3225,3188,3225,-25,42616400,Neutral,0.0
20/09/2018,3338,3338,3213,3213,125,99827000,Positive,0.5106
21/09/2018,3425,3475,3363,3375,50,124841800,Positive,0.5267
24/09/2018,3375,3450,3338,3425,-50,81188200,Neutral,0.0
25/09/2018,3313,3375,3263,3338,-25,46091400,Negative,-0.2732
26/09/2018,3300,3363,3288,3288,12,32016600,Neutral,0.0
27/09/2018,3313,3363,3275,3300,13,82349800,Positive,"0,0793"
28/09/2018,3363,3375,3300,3300,63,101686800,Neutral,0.0
01/10/2018,3350,3400,3300,3300,50,66513400,Neutral,0.0
02/10/2018,3225,3350,3213,3350,-125,120652800,Neutral,0.0
03/10/2018,3250,3288,3200,3200,50,68383400,Positive,"0,2128"
04/10/2018,3113,3213,3113,3200,-87,116478400,Neutral,0.0
05/10/2018,3138,3175,3088,3113,25,67792400,Positive,0.3182
08/10/2018,3100,3150,3100,3138,-38,55327600,Negative,-0.2732
09/10/2018,3175,3188,3100,3100,75,40331400,Positive,0.1779
10/10/2018,3238,3263,3188,3200,38,39230800,Neutral,0.0
11/10/2018,3138,3175,3100,3125,13,64054000,Neutral,0.0
12/10/2018,3200,3238,3138,3138,62,70448200,Neutral,0.0
15/10/2018,3188,3263,3188,3250,-62,40880400,Neutral,0.0
16/10/2018,3250,3250,3200,3200,50,29777600,Neutral,0.0
17/10/2018,3288,3325,3263,3300,-12,43108000,Negative,"-0,3523"
18/10/2018,3250,3300,3200,3250,0,39270000,Neutral,0.0
19/10/2018,3225,3250,3188,3225,0,47990000,Neutral,0.0
22/10/2018,3225,3263,3188,3225,0,36415600,Neutral,0.0
23/10/2018,3213,3238,3213,3225,-12,25707400,Positive,0.2023
24/10/2018,3163,3238,3163,3213,-50,33969400,Neutral,0.0
25/10/2018,3238,3238,3125,3125,113,62781600,Positive,"0,9283"
26/10/2018,3225,3250,3200,3238,-13,39723200,Negative,"-0,2706"
29/10/2018,3200,3250,3200,3213,-13,40472000,Negative,"-0,3037"
30/10/2018,3263,3263,3213,3250,13,34731200,Positive,"0,9187"
31/10/2018,3425,3425,3275,3288,137,111265400,Neutral,0.0
01/11/2018,3613,3675,3438,3450,163,185151800,Positive,0.296
02/11/2018,3713,3750,3550,3663,50,143785200,Positive,0.1779
05/11/2018,3688,3700,3625,3700,-12,56013400,Positive,0.5994
06/11/2018,3675,3738,3625,3738,-63,124000800,Neutral,0.0
07/11/2018,3675,3700,3600,3688,-13,92281000,Positive,0.2263
08/11/2018,3750,3763,3688,3700,50,130444200,Neutral,0.0
09/11/2018,3613,3663,3575,3625,-12,123465600,Neutral,0.0
12/11/2018,3488,3613,3488,3613,-125,65689800,Negative,"-0,4886"
13/11/2018,3575,3588,3400,3400,175,85750000,Positive,"0,7244"
14/11/2018,3563,3650,3563,3638,-75,68203400,Negative,"-0,4826"
15/11/2018,3700,3725,3575,3625,75,115193000,Positive,"0,8587"
16/11/2018,3725,3813,3688,3738,-13,113146000,Negative,"-0,3592"
19/11/2018,3738,3788,3650,3750,-12,52926800,Negative,"-0,4544"
20/11/2018,3738,3738,3738,3738,0,0,Positive,0.5106
21/11/2018,3638,3663,3525,3613,25,121808800,Positive,0.5106
22/11/2018,3663,3700,3588,3638,25,89601400,Positive,0.5106
23/11/2018,3650,3700,3638,3675,-25,82350000,Negative,-0.1027
26/11/2018,3688,3700,3625,3625,63,62934800,Positive,0.6369
27/11/2018,3725,3750,3675,3688,37,61028800,Neutral,0.0
28/11/2018,3700,3750,3663,3750,-50,67675000,Neutral,0.0
29/11/2018,3825,3825,3750,3750,75,141202600,Positive,"0,0197"
30/11/2018,3700,3813,3700,3788,-88,148482800,Positive,0.1779
03/12/2018,3800,3863,3775,3775,25,136684600,Neutral,0.0
04/12/2018,3825,3825,3775,3788,37,60153200,Positive,"0,4646"
05/12/2018,3788,3800,3763,3800,-12,73322400,Neutral,0.0
06/12/2018,3738,3763,3700,3700,38,74092000,Neutral,0.0
07/12/2018,3750,3813,3738,3788,-38,41692800,Neutral,0.0
10/12/2018,3713,3763,3675,3688,25,41105200,Negative,-0.1779
11/12/2018,3725,3738,3700,3725,0,55657400,Neutral,0.0
12/12/2018,3738,3775,3713,3738,0,80631400,Positive,"0,7464"
13/12/2018,3850,3850,3725,3750,100,92920000,Positive,0.6369
14/12/2018,3788,3825,3763,3825,-37,68756400,Neutral,0.0
17/12/2018,3700,3788,3700,3725,-25,78685000,Neutral,0.0
18/12/2018,3675,3675,3625,3625,50,98608800,Neutral,0.0
19/12/2018,3713,3738,3675,3675,38,89550000,Neutral,0.0
20/12/2018,3650,3713,3638,3713,-63,61216000,Neutral,0.0
21/12/2018,3613,3650,3588,3625,-12,98207400,Negative,"-0,1852"
24/12/2018,3613,3613,3613,3613,0,0,Neutral,0.0
25/12/2018,3613,3613,3613,3613,0,0,Positive,"0,1686"
26/12/2018,3613,3625,3550,3575,38,52356800,Positive,0.7964
27/12/2018,3638,3675,3625,3663,-25,48514400,Negative,"-0,25"
28/12/2018,3688,3725,3663,3675,13,97081600,Neutral,0.0
31/12/2018,3688,3688,3688,3688,0,0,Positive,"0,1491"
01/01/2019,3688,3688,3688,3688,0,0,Positive,"0,5311"
02/01/2019,3663,3700,3625,3700,-37,45319200,Neutral,0.0
03/01/2019,3588,3675,3550,3638,-50,74174000,Positive,0.5423
04/01/2019,3725,3725,3575,3588,137,78514000,Neutral,0.0
07/01/2019,3713,3788,3713,3750,-37,53624800,Negative,"-0,4322"
08/01/2019,3675,3738,3675,3713,-38,80073200,Negative,"-0,4298"
09/01/2019,3788,3788,3700,3750,38,104903400,Positive,"0,5079"
10/01/2019,3850,3850,3775,3813,37,130603200,Positive,"0,999"
11/01/2019,3850,3900,3838,3875,-25,88899400,Negative,"-0,1642"
14/01/2019,3850,3875,3825,3875,-25,71320000,Negative,"-0,3341"
15/01/2019,3900,3900,3825,3875,25,86697200,Positive,"0,9273"
16/01/2019,3900,3913,3838,3900,0,78625600,Positive,"0,1552"
17/01/2019,3938,4025,3900,3900,38,101961200,Positive,"0,4742"
18/01/2019,3938,3963,3913,3950,-12,56790000,Negative,"-0,2743"
21/01/2019,3900,3950,3900,3913,-13,111624400,Neutral,0.0
22/01/2019,3875,3900,3825,3863,12,123558000,Negative,-0.2732
23/01/2019,3738,3850,3738,3788,-50,162196000,Negative,-0.3818
24/01/2019,3738,3750,3713,3738,0,179821400,Neutral,0.0
25/01/2019,3688,3763,3650,3738,-50,143184800,Neutral,0.0
28/01/2019,3588,3713,3538,3688,-100,207013400,Neutral,0.0
29/01/2019,3563,3625,3525,3588,-25,162587800,Neutral,0.0
30/01/2019,3625,3663,3563,3563,62,175565200,Positive,"0,6546"
31/01/2019,3725,3738,3638,3663,62,214008600,Positive,"0,0951"
01/02/2019,3800,3813,3738,3750,50,104295400,Positive,0.5267
04/02/2019,3675,3800,3675,3750,-75,80919200,Positive,0.3818
05/02/2019,3675,3675,3675,3675,0,0,Positive,0.2023
06/02/2019,3738,3763,3713,3725,13,60281400,Neutral,0.0
07/02/2019,3775,3775,3713,3738,37,31622800,Neutral,0.0
08/02/2019,3788,3788,3713,3750,38,46828400,Neutral,0.0
11/02/2019,3813,3813,3763,3800,13,72358200,Positive,0.5267
12/02/2019,3713,3838,3688,3838,-125,82644200,Negative,-0.2732
13/02/2019,3625,3738,3625,3713,-88,75046400,Negative,-0.3818
14/02/2019,3588,3688,3588,3675,-87,95699000,Negative,"-0,3764"
15/02/2019,3588,3613,3550,3575,13,92002800,Neutral,0.0
18/02/2019,3638,3650,3588,3650,-12,86216800,Negative,"-0,1072"
19/02/2019,3600,3663,3563,3638,-38,92714200,Neutral,0.0
20/02/2019,3550,3625,3475,3625,-75,192881200,Positive,0.296
21/02/2019,3663,3663,3550,3563,100,100203800,Neutral,0.0
22/02/2019,3550,3650,3525,3638,-88,167596800,Neutral,0.0
25/02/2019,3625,3625,3563,3575,50,91520000,Positive,"0,8525"
26/02/2019,3638,3638,3575,3638,0,94091000,Positive,"0,8776"
27/02/2019,3600,3638,3575,3600,0,72356800,Positive,"0,9104"
28/02/2019,3563,3625,3550,3613,-50,84980200,Negative,"-0,179"
01/03/2019,3588,3613,3563,3575,13,47003200,Positive,"0,8576"
04/03/2019,3550,3588,3550,3588,-38,29659800,Negative,"-0,3591"
05/03/2019,3475,3563,3400,3525,-50,223113200,Neutral,0.0
06/03/2019,3538,3538,3438,3500,38,94977600,Positive,0.3612
07/03/2019,3538,3538,3538,3538,0,0,Neutral,0.0
08/03/2019,3450,3525,3450,3525,-75,71523400,Negative,"-0,3616"
11/03/2019,3425,3475,3413,3475,-50,53912400,Negative,-0.1779
12/03/2019,3363,3438,3338,3413,-50,60509600,Neutral,0.0
13/03/2019,3350,3400,3325,3400,-50,55730600,Neutral,0.0
14/03/2019,3450,3463,3363,3400,50,44212200,Neutral,0.0
15/03/2019,3550,3550,3463,3463,87,71744400,Positive,0.5267
18/03/2019,3550,3613,3513,3575,-25,52140200,Negative,"-0,2573"
19/03/2019,3688,3700,3575,3588,100,158696000,Positive,"0,4443"
20/03/2019,3700,3725,3650,3700,0,51652800,Positive,"0,374"
21/03/2019,3738,3763,3725,3750,-12,68829800,Positive,0.34
22/03/2019,3725,3750,3713,3738,-13,45259400,Neutral,0.0
25/03/2019,3588,3663,3588,3625,-37,45751600,Neutral,0.0
26/03/2019,3650,3675,3638,3638,12,28799400,Neutral,0.0
27/03/2019,3613,3713,3613,3713,-100,38906600,Neutral,0.0
28/03/2019,3688,3688,3625,3650,38,47868600,Neutral,0.0
29/03/2019,3738,3750,3663,3700,38,71140200,Neutral,0.0
01/04/2019,3750,3763,3725,3750,0,57890600,Neutral,0.0
02/04/2019,3713,3763,3663,3763,-50,36872800,Neutral,0.0
03/04/2019,3713,3713,3713,3713,0,0,Neutral,0.0
04/04/2019,3838,3850,3750,3750,88,119083400,Positive,0.1779
05/04/2019,3775,3838,3775,3838,-63,40534200,Negative,-0.296
08/04/2019,3750,3800,3688,3800,-50,45862600,Negative,"-0,1401"
09/04/2019,3838,3863,3775,3788,50,61437800,Positive,"0,7257"
10/04/2019,3775,3838,3763,3825,-50,30552600,Negative,"-0,4216"
11/04/2019,3700,3800,3700,3788,-88,70389000,Negative,"-0,4652"
12/04/2019,3663,3700,3650,3675,-12,53372400,Neutral,0.0
15/04/2019,3675,3725,3663,3700,-25,48251000,Neutral,0.0
16/04/2019,3813,3813,3675,3688,125,143066800,Neutral,0.0
17/04/2019,3813,3813,3813,3813,0,0,Neutral,0.0
18/04/2019,3900,4063,3888,3900,0,243343400,Positive,0.5267
19/04/2019,3900,3900,3900,3900,0,0,Positive,"0,954"
22/04/2019,3875,3938,3825,3900,-25,69981800,Negative,"-0,3529"
23/04/2019,3838,3888,3838,3850,-12,65384600,Negative,"-0,3341"
24/04/2019,3838,3863,3813,3850,-12,55408400,Negative,"-0,3879"
25/04/2019,3825,3838,3775,3825,0,111185200,Positive,"0,4222"
26/04/2019,3863,3900,3738,3775,88,150697400,Positive,"0,8001"
29/04/2019,3888,3900,3838,3850,38,112773000,Neutral,0.0
30/04/2019,3863,3938,3863,3913,-50,103243000,Positive,0.2023
01/05/2019,3863,3863,3863,3863,0,0,Positive,"0,727"
02/05/2019,3850,3863,3813,3850,0,68943800,Neutral,0.0
03/05/2019,3825,3850,3788,3850,-25,60141600,Positive,0.3818
06/05/2019,3763,3788,3663,3750,13,100956600,Positive,"0,5661"
07/05/2019,3825,3838,3775,3838,-13,68861800,Negative,"-0,1015"
08/05/2019,3763,3788,3725,3750,13,79916800,Positive,"0,9014"
09/05/2019,3750,3788,3725,3725,25,90947000,Positive,"0,3462"
10/05/2019,3738,3788,3688,3775,-37,65009400,Negative,"-0,4737"
13/05/2019,3763,3825,3750,3788,-25,83342800,Neutral,0.0
14/05/2019,3725,3763,3700,3725,0,85983800,Neutral,0.0
15/05/2019,3713,3800,3713,3763,-50,112972400,Neutral,0.0
16/05/2019,3675,3725,3625,3675,0,86481000,Positive,0.0516
17/05/2019,3538,3750,3538,3750,-212,59716600,Negative,"-0,3704"
20/05/2019,3613,3638,3488,3500,113,93447200,Positive,"0,3544"
21/05/2019,3625,3675,3538,3638,-13,128877200,Negative,"-0,4887"
22/05/2019,3650,3700,3613,3663,-13,88253000,Negative,"-0,4378"
23/05/2019,3788,3800,3663,3675,113,65668800,Positive,"0,2332"
24/05/2019,3850,3888,3788,3800,50,99151200,Positive,"0,2566"
27/05/2019,3863,3863,3763,3800,63,144611000,Neutral,0.0
28/05/2019,3688,3850,3675,3850,-162,298780800,Negative,-0.2023
29/05/2019,3775,3775,3700,3725,50,89397400,Neutral,0.0
30/05/2019,3775,3775,3775,3775,0,0,Positive,"0,1578"
31/05/2019,3838,3888,3775,3800,38,173453000,Positive,"0,4662"
03/06/2019,3838,3838,3838,3838,0,0,Positive,"0,0423"
04/06/2019,3838,3838,3838,3838,0,0,Positive,"0,7863"
05/06/2019,3838,3838,3838,3838,0,0,Positive,"0,2644"
06/06/2019,3838,3838,3838,3838,0,0,Positive,"0,9258"
07/06/2019,3838,3838,3838,3838,0,0,Positive,"0,3819"
10/06/2019,3925,3975,3913,3925,0,208042400,Negative,-0.1779
11/06/2019,3938,3950,3900,3938,0,107140400,Neutral,0.0
12/06/2019,3938,3950,3900,3950,-12,69330800,Neutral,0.0
13/06/2019,3913,3950,3850,3938,-25,63482400,Neutral,0.0
14/06/2019,3913,3938,3900,3938,-25,61672200,Negative,"-0,3555"
17/06/2019,3900,3950,3900,3950,-50,47269400,Neutral,0.0
18/06/2019,3925,3938,3888,3888,37,104106200,Positive,0.7351
19/06/2019,3988,4000,3938,3950,38,156615200,Neutral,0.0
20/06/2019,3975,4025,3963,4000,-25,93589200,Neutral,0.0
21/06/2019,3988,4013,3950,4000,-12,145919600,Neutral,0.0
24/06/2019,3988,4013,3950,3950,38,70252200,Neutral,0.0
25/06/2019,3975,4013,3963,4013,-38,59303200,Neutral,0.0
26/06/2019,3975,4000,3925,3925,50,72115200,Neutral,0.0
27/06/2019,4000,4025,3988,3988,12,63152000,Negative,-0.6908
28/06/2019,4013,4025,3988,4013,0,61888000,Positive,"0,5995"
01/07/2019,4000,4038,3988,4025,-25,61455600,Neutral,0.0
02/07/2019,4013,4025,3988,4025,-12,64875600,Negative,"-0,1629"
03/07/2019,4013,4013,3975,3975,38,93933600,Positive,0.3818
04/07/2019,4013,4025,4000,4025,-12,31578600,Neutral,0.0
05/07/2019,3913,4013,3863,3963,-50,186756200,Negative,-0.1779
08/07/2019,3938,3938,3863,3875,63,105905600,Positive,"0,1862"
09/07/2019,3950,3963,3900,3913,37,88590800,Positive,"0,5859"
10/07/2019,3975,4000,3963,3975,0,100964600,Positive,"0,4365"
11/07/2019,4000,4025,3988,4013,-13,70231200,Negative,"-0,3872"
12/07/2019,4038,4063,4013,4025,13,73474000,Positive,"0,0286"
15/07/2019,4075,4088,4050,4075,0,89444800,Positive,0.1779
16/07/2019,4038,4063,3988,4038,0,146626400,Neutral,0.0
17/07/2019,3988,4025,3975,4000,-12,128231000,Neutral,0.0
18/07/2019,3925,3975,3913,3950,-25,142262000,Neutral,0.0
19/07/2019,3938,3950,3900,3900,38,104530000,Positive,"0,0861"
22/07/2019,3888,3913,3875,3900,-12,82851000,Neutral,0.0
23/07/2019,3850,3925,3850,3913,-63,74981800,Neutral,0.0
24/07/2019,3850,3913,3850,3850,0,65565800,Positive,0.1779
25/07/2019,3900,3900,3850,3863,37,77462000,Neutral,0.0
26/07/2019,3875,3888,3813,3825,50,62727400,Positive,"0,725"
29/07/2019,3900,3913,3838,3913,-13,55206400,Positive,0.296
30/07/2019,3975,3988,3863,3900,75,87075600,Positive,0.1779
31/07/2019,3988,3988,3900,3938,50,59008800,Positive,0.3818
01/08/2019,3888,3950,3863,3938,-50,96731000,Neutral,0.0
02/08/2019,3838,3875,3800,3850,-12,103727000,Neutral,0.0
05/08/2019,3713,3825,3663,3800,-87,129862600,Negative,-0.1779
06/08/2019,3625,3700,3550,3650,-25,157132400,Negative,"-0,1451"
07/08/2019,3675,3700,3638,3638,37,103932800,Positive,"0,8212"
08/08/2019,3750,3763,3675,3725,25,85711800,Neutral,0.0
09/08/2019,3725,3775,3725,3750,-25,39017600,Neutral,0.0
12/08/2019,3700,3750,3675,3750,-50,69256600,Negative,"-0,1271"
13/08/2019,3675,3775,3650,3775,-100,68067800,Positive,0.4019
14/08/2019,3750,3763,3675,3750,0,107613000,Neutral,0.0
15/08/2019,3700,3700,3650,3675,25,57456400,Neutral,0.0
16/08/2019,3688,3713,3663,3700,-12,47693000,Negative,"-0,3571"
19/08/2019,3675,3725,3663,3725,-50,38551200,Neutral,0.0
20/08/2019,3688,3725,3650,3713,-25,75396200,Negative,"-0,1623"
21/08/2019,3613,3675,3613,3663,-50,49841400,Neutral,0.0
22/08/2019,3613,3663,3575,3650,-37,77652800,Negative,"-0,1345"
23/08/2019,3588,3625,3575,3625,-37,44535800,Negative,"-0,1235"
26/08/2019,3525,3550,3500,3550,-25,78614600,Negative,"-0,2706"
27/08/2019,3513,3563,3513,3525,-12,153201600,Negative,"-0,2741"
28/08/2019,3525,3550,3475,3513,12,96082400,Positive,"0,2412"
29/08/2019,3538,3550,3513,3525,13,63748800,Positive,0.2263
30/08/2019,3625,3625,3538,3563,62,106370600,Neutral,0.0
02/09/2019,3588,3613,3563,3613,-25,37622200,Positive,0.2263
03/09/2019,3450,3600,3413,3588,-138,96998200,Neutral,0.0
04/09/2019,3463,3488,3425,3488,-25,74434600,Neutral,0.0
05/09/2019,3488,3513,3463,3500,-12,78642800,Positive,0.2732
06/09/2019,3525,3575,3488,3513,12,88646000,Neutral,0.0
09/09/2019,3488,3538,3463,3538,-50,55841400,Neutral,0.0
10/09/2019,3525,3525,3450,3450,75,52070400,Neutral,0.0
11/09/2019,3575,3575,3475,3500,75,80777800,Positive,"0,959"
12/09/2019,3575,3663,3550,3625,-50,84564600,Negative,"-0,435"
13/09/2019,3600,3625,3563,3613,-13,28700200,Negative,"-0,1692"
16/09/2019,3500,3550,3463,3525,-25,66615800,Negative,"-0,3878"
17/09/2019,3488,3550,3463,3463,25,70992200,Positive,"0,4983"
18/09/2019,3600,3600,3525,3538,62,53708400,Neutral,0.0
19/09/2019,3550,3588,3538,3588,-38,35941600,Neutral,0.0
20/09/2019,3538,3575,3488,3550,-12,104743400,Neutral,0.0
23/09/2019,3500,3550,3475,3525,-25,49012600,Negative,"-0,2685"
24/09/2019,3475,3488,3425,3463,12,52110000,Positive,"0,7363"
25/09/2019,3450,3500,3438,3488,-38,37565400,Negative,"-0,3968"
26/09/2019,3550,3550,3475,3500,50,45471400,Positive,"0,57"
27/09/2019,3488,3525,3475,3500,-12,44329400,Negative,"-0,1255"
30/09/2019,3488,3488,3450,3450,38,58294000,Positive,"0,1129"
01/10/2019,3450,3525,3450,3450,0,31243400,Positive,"0,3038"
02/10/2019,3263,3475,3250,3438,-175,129586200,Negative,"-0,1675"
03/10/2019,3200,3263,3138,3263,-63,146789000,Negative,"-0,2417"
04/10/2019,3200,3263,3163,3225,-25,69121800,Negative,"-0,1603"
07/10/2019,3175,3238,3163,3238,-63,36656400,Negative,"-0,3999"
08/10/2019,3250,3250,3175,3175,75,104992000,Neutral,0.0
09/10/2019,3213,3238,3200,3225,-12,55131400,Neutral,0.0
10/10/2019,3263,3300,3213,3213,50,120255400,Neutral,0.0
11/10/2019,3275,3325,3238,3250,25,96816400,Neutral,0.0
14/10/2019,3300,3338,3250,3313,-13,65272800,Negative,"-0,1276"
15/10/2019,3288,3300,3250,3275,13,94139600,Positive,"0,2391"
16/10/2019,3313,3325,3275,3300,13,118973800,Positive,"0,1937"
17/10/2019,3350,3350,3313,3313,37,150037800,Positive,"0,7213"
18/10/2019,3388,3438,3325,3338,50,117544400,Positive,"0,4521"
21/10/2019,3400,3413,3350,3400,0,83622800,Positive,"0,2655"
22/10/2019,3413,3425,3375,3425,-12,62050200,Negative,"-0,3387"
23/10/2019,3538,3550,3375,3413,125,98440400,Positive,"0,4053"
24/10/2019,3613,3625,3538,3563,50,132797200,Neutral,0.0
25/10/2019,3500,3638,3488,3638,-138,105735200,Neutral,0.0
28/10/2019,3500,3538,3463,3500,0,46389600,Positive,"0,8869"
29/10/2019,3550,3575,3500,3550,0,91735400,Neutral,0.0
30/10/2019,3513,3538,3488,3538,-25,47667200,Positive,0.25
31/10/2019,3513,3525,3450,3525,-12,78160000,Neutral,0.0
01/11/2019,3488,3513,3463,3513,-25,24366800,Negative,-0.1779
04/11/2019,3438,3513,3438,3500,-62,56584800,Negative,"-0,1606"
05/11/2019,3600,3600,3463,3475,125,94253000,Positive,"0,4565"
06/11/2019,3488,3600,3413,3588,-100,113175200,Negative,"-0,4866"
07/11/2019,3500,3513,3388,3513,-13,78753600,Negative,"-0,1978"
08/11/2019,3550,3575,3425,3488,62,76355000,Positive,"0,7579"
11/11/2019,3525,3550,3488,3538,-13,45212000,Neutral,0.0
12/11/2019,3513,3550,3463,3500,13,52900800,Neutral,0.0
13/11/2019,3438,3500,3388,3500,-62,75148400,Neutral,0.0
14/11/2019,3438,3450,3350,3438,0,66698600,Neutral,0.0
15/11/2019,3475,3513,3463,3463,12,47017200,Positive,0.1779
18/11/2019,3488,3513,3438,3475,13,61287000,Positive,"0,8883"
19/11/2019,3575,3575,3475,3513,62,67006200,Positive,"0,7867"
20/11/2019,3550,3600,3525,3575,-25,46727600,Negative,"-0,4048"
21/11/2019,3588,3600,3475,3500,88,60944600,Neutral,0.0
22/11/2019,3538,3588,3525,3550,-12,40452800,Positive,0.2023
25/11/2019,3488,3525,3463,3500,-12,47676200,Neutral,0.0
26/11/2019,3463,3525,3450,3500,-37,173533200,Neutral,0.0
27/11/2019,3450,3488,3400,3413,37,72928800,Neutral,0.0
28/11/2019,3388,3450,3388,3425,-37,56275200,Neutral,0.0
29/11/2019,3488,3500,3388,3388,100,53250600,Neutral,0.0
02/12/2019,3550,3575,3463,3488,62,74561000,Positive,"0,3582"
03/12/2019,3588,3588,3513,3525,63,79039000,Positive,"0,1537"
04/12/2019,3538,3575,3525,3538,0,65802200,Positive,"0,4759"
05/12/2019,3588,3600,3538,3550,38,74217800,Positive,"0,2337"
06/12/2019,3588,3613,3563,3600,-12,53720600,Negative,"-0,4122"
09/12/2019,3625,3650,3600,3600,25,72098600,Neutral,0.0
10/12/2019,3688,3700,3600,3600,88,132230000,Neutral,0.0
11/12/2019,3675,3700,3663,3675,0,68454200,Neutral,0.0
12/12/2019,3650,3725,3638,3663,-13,79738600,Neutral,0.0
13/12/2019,3688,3725,3675,3700,-12,127472400,Neutral,0.0
16/12/2019,3675,3713,3675,3675,0,96037400,Neutral,0.0
17/12/2019,3675,3700,3663,3675,0,100790000,Negative,-0.0772
18/12/2019,3763,3775,3663,3675,88,123281600,Positive,0.2263
19/12/2019,3800,3800,3738,3763,37,112903200,Neutral,0.0
20/12/2019,3850,3850,3775,3775,75,150472200,Positive,"0,5861"
23/12/2019,3863,3900,3838,3900,-37,131246800,Negative,"-0,334"
26/12/2019,3900,3913,3875,3888,12,140936400,Positive,"0,4623"
27/12/2019,3875,3913,3863,3913,-38,58182800,Negative,"-0,2632"
30/12/2019,3838,3900,3825,3863,-25,78005800,Negative,"-0,4422"
02/01/2020,3875,3888,3825,3838,37,37379800,Positive,"0,8428"
03/01/2020,3863,3913,3813,3875,-12,70294600,Negative,"-0,2484"
06/01/2020,3800,3838,3763,3825,-25,61892000,Negative,"-0,2203"
07/01/2020,3800,3863,3788,3863,-63,70895600,Negative,"-0,236"
08/01/2020,3750,3775,3688,3775,-25,105080600,Negative,"-0,3497"
09/01/2020,3850,3863,3763,3775,75,75587000,Positive,"0,7555"
10/01/2020,3863,3863,3825,3850,13,64231800,Positive,"0,4281"
13/01/2020,3863,3875,3825,3863,0,75399600,Positive,"0,7033"
14/01/2020,3875,3900,3850,3900,-25,104134400,Negative,"-0,2013"
15/01/2020,3825,3900,3800,3875,-50,89795200,Negative,"-0,2595"
16/01/2020,3775,3838,3763,3800,-25,145432200,Neutral,0.0
17/01/2020,3863,3875,3763,3788,75,130500200,Positive,"0,9104"
20/01/2020,3813,3900,3800,3900,-87,24031800,Neutral,0.0
21/01/2020,3850,3875,3813,3875,-25,39166600,Neutral,0.0
22/01/2020,3900,3925,3863,3875,25,122175200,Neutral,0.0
23/01/2020,3888,3913,3850,3900,-12,83127800,Neutral,0.0
24/01/2020,3963,4000,3863,3913,50,154702000,Neutral,0.0
27/01/2020,3863,3988,3850,3975,-112,98280000,Negative,"-0,2728"
28/01/2020,3875,3913,3800,3825,50,69349600,Positive,"0,8157"
29/01/2020,3900,3963,3888,3913,-13,109661000,Negative,"-0,18"
30/01/2020,3825,3913,3800,3900,-75,85395600,Negative,"-0,1448"
31/01/2020,3775,3850,3725,3838,-63,157661000,Neutral,0.0
03/02/2020,3750,3788,3675,3700,50,87271800,Neutral,0.0
04/02/2020,3763,3838,3750,3800,-37,138857400,Positive,0.7506
05/02/2020,3850,3850,3775,3800,50,130211200,Neutral,0.0
06/02/2020,3850,3925,3838,3900,-50,111029400,Negative,"-0,4148"
07/02/2020,3863,3875,3838,3838,25,86438600,Positive,"0,6679"
10/02/2020,3863,3875,3800,3850,13,78553800,Positive,"0,1824"
11/02/2020,3888,3913,3838,3863,25,98520200,Neutral,0.0
12/02/2020,3900,3950,3888,3913,-13,104678800,Neutral,0.0
13/02/2020,3925,3975,3900,3913,12,87904000,Neutral,0.0
14/02/2020,3913,3925,3875,3875,38,41345200,Neutral,0.0
17/02/2020,3925,3938,3900,3925,0,29816600,Positive,"0,2865"
18/02/2020,3913,3925,3900,3900,13,65442000,Positive,"0,0625"
19/02/2020,3975,3975,3900,3925,50,121614200,Positive,"0,6139"
20/02/2020,4000,4025,3963,4013,-13,114537600,Neutral,0.0
21/02/2020,3950,4000,3913,3975,-25,91798000,Neutral,0.0
24/02/2020,3888,3913,3825,3900,-12,128768800,Positive,0.296
25/02/2020,3900,3950,3850,3888,12,105951800,Neutral,0.0
26/02/2020,3825,3875,3825,3875,-50,198171000,Negative,"-0,3298"
27/02/2020,3675,3850,3625,3825,-150,223088600,Negative,"-0,1657"
28/02/2020,3638,3638,3275,3375,263,188868200,Neutral,0.0
02/03/2020,3475,3625,3475,3575,-100,101550200,Negative,"-0,2808"
03/03/2020,3600,3675,3513,3550,50,96445200,Positive,"0,4479"
04/03/2020,3738,3750,3613,3625,113,92555400,Positive,"0,2649"
05/03/2020,3800,3825,3750,3775,25,104748600,Positive,"0,5814"
06/03/2020,3625,3700,3613,3700,-75,72311200,Negative,"-0,2212"
09/03/2020,3288,3500,3288,3500,-212,113132400,Neutral,0.0
10/03/2020,3438,3500,3325,3325,113,114052000,Positive,0.1779
11/03/2020,3413,3525,3313,3463,-50,97168800,Neutral,0.0
12/03/2020,3213,3338,3113,3238,-25,91578200,Neutral,0.0
13/03/2020,3175,3238,3000,3100,75,238623800,Positive,"0,4587"
16/03/2020,3175,3175,3175,3175,0,0,Neutral,0.0
17/03/2020,2763,2963,2763,2963,-200,186380400,Negative,-0.2023
18/03/2020,2575,2825,2575,2800,-225,215103400,Negative,"-0,4048"
19/03/2020,2395,2500,2395,2500,-105,167876200,Neutral,0.0
20/03/2020,2230,2370,2230,2370,-140,478236600,Negative,-0.3818
23/03/2020,2075,2175,2075,2175,-100,59985800,Negative,-0.6249
24/03/2020,1930,2115,1930,2075,-145,237296200,Negative,"-0,1063"
26/03/2020,2235,2290,1890,1900,335,386557200,Neutral,0.0
27/03/2020,2470,2613,2250,2255,215,396812000,Neutral,0.0
30/03/2020,2300,2420,2300,2420,-120,39766600,Neutral,0.0
31/03/2020,2340,2410,2225,2325,15,208047600,Neutral,0.0
01/04/2020,2305,2440,2220,2325,-20,152367000,Neutral,0.0
02/04/2020,2375,2375,2180,2285,90,132225200,Neutral,0.0
03/04/2020,2513,2513,2400,2400,113,105225600,Positive,"0,1783"
06/04/2020,2600,2613,2450,2513,87,113980400,Neutral,0.0
07/04/2020,2563,2800,2485,2700,-137,191464600,Positive,0.5267
08/04/2020,2385,2588,2385,2588,-203,155834800,Neutral,0.0
09/04/2020,2335,2450,2305,2400,-65,163570800,Neutral,0.0
13/04/2020,2235,2340,2235,2340,-105,115331000,Positive,0.1531
14/04/2020,2285,2320,2200,2240,45,132848000,Neutral,0.0
15/04/2020,2200,2345,2200,2320,-120,124661000,Neutral,0.0
16/04/2020,2105,2200,2075,2200,-95,215224000,Positive,0.1531
17/04/2020,2190,2210,2110,2110,80,163407600,Positive,"0,0128"
20/04/2020,2185,2265,2135,2225,-40,120672000,Neutral,0.0
21/04/2020,2175,2205,2125,2185,-10,92203200,Negative,-0.1779
22/04/2020,2245,2250,2125,2165,80,126786800,Neutral,0.0
23/04/2020,2250,2285,2240,2245,5,115336400,Neutral,0.0
24/04/2020,2140,2250,2140,2250,-110,131631400,Neutral,0.0
27/04/2020,2075,2175,2045,2155,-80,205382600,Negative,"-0,1051"
28/04/2020,2075,2120,2035,2095,-20,157370600,Neutral,0.0
29/04/2020,2000,2110,2000,2100,-100,192650200,Neutral,0.0
30/04/2020,2230,2240,2030,2035,195,229509600,Neutral,0.0
04/05/2020,2145,2230,2120,2230,-85,80572600,Neutral,0.0
05/05/2020,2110,2200,2080,2150,-40,185282400,Neutral,0.0
06/05/2020,2080,2130,2080,2125,-45,138733000,Positive,0.1779
08/05/2020,2100,2155,2090,2100,0,127482200,Negative,-0.1779
11/05/2020,2115,2140,2095,2140,-25,83552200,Neutral,0.0
12/05/2020,2005,2115,2000,2115,-110,188578000,Neutral,0.0
13/05/2020,2005,2025,1950,1995,10,134821600,Negative,-0.2023
14/05/2020,1975,2005,1950,1985,-10,141388800,Negative,"-0,3423"
15/05/2020,1880,1995,1840,1975,-95,227234200,Negative,"-0,2887"
18/05/2020,1860,1900,1830,1900,-40,158710600,Neutral,0.0
19/05/2020,1930,2000,1880,1880,50,199655000,Neutral,0.0
20/05/2020,2035,2060,1915,1925,110,237644400,Positive,0.1779
26/05/2020,2050,2080,2030,2065,-15,180545000,Positive,0.5574
27/05/2020,2055,2100,2005,2075,-20,124329600,Neutral,0.0
28/05/2020,2145,2170,2075,2075,70,265460200,Positive,0.34
29/05/2020,2235,2245,2125,2145,90,350546800,Positive,"0,9453"
02/06/2020,2310,2495,2265,2275,35,207635400,Negative,-0.1531
03/06/2020,2430,2475,2295,2335,95,296607800,Positive,"0,4498"
04/06/2020,2365,2500,2360,2450,-85,169836200,Positive,0.5106
05/06/2020,2425,2435,2300,2365,60,185391000,Positive,"0,8411"
08/06/2020,2625,2663,2475,2500,125,292605200,Neutral,0.0
09/06/2020,2638,2725,2575,2650,-12,147413600,Neutral,0.0
10/06/2020,2455,2613,2455,2600,-145,289644200,Negative,"-0,4288"
11/06/2020,2345,2435,2285,2400,-55,364783800,Negative,-0.1779
12/06/2020,2445,2450,2215,2295,150,289959400,Neutral,0.0
15/06/2020,2360,2455,2345,2425,-65,169814600,Neutral,0.0
16/06/2020,2513,2525,2410,2410,103,146116600,Neutral,0.0
17/06/2020,2450,2600,2445,2550,-100,213944600,Negative,"-0,1469"
18/06/2020,2410,2485,2390,2420,-10,152175200,Negative,"-0,1161"
19/06/2020,2440,2475,2410,2440,0,126356800,Neutral,0.0
22/06/2020,2405,2455,2400,2440,-35,66825000,Neutral,0.0
23/06/2020,2395,2425,2345,2425,-30,95010400,Positive,0.2732
24/06/2020,2575,2600,2445,2445,130,278417000,Neutral,0.0
25/06/2020,2513,2600,2470,2538,-25,146123000,Positive,0.1531
26/06/2020,2500,2575,2490,2563,-63,85829000,Neutral,0.0
29/06/2020,2470,2500,2435,2490,-20,99123000,Neutral,0.0
30/06/2020,2475,2525,2475,2513,-38,113994400,Negative,-0.34
01/07/2020,2495,2513,2455,2500,-5,67747600,Neutral,0.0
02/07/2020,2500,2513,2480,2490,10,80606600,Positive,"0,1971"
03/07/2020,2500,2538,2450,2480,20,57839800,Positive,"0,704"
06/07/2020,2538,2575,2500,2500,38,90019000,Neutral,0.0
07/07/2020,2525,2575,2525,2563,-38,80447600,Positive,0.6705
08/07/2020,2638,2675,2513,2525,113,149466800,Negative,-0.3818
09/07/2020,2625,2700,2600,2675,-50,98277200,Negative,-0.0772
10/07/2020,2588,2638,2563,2625,-37,77850000,Neutral,0.0
13/07/2020,2625,2663,2613,2625,0,72688200,Neutral,0.0
14/07/2020,2650,2663,2600,2650,0,78259800,Positive,0.6486
15/07/2020,2638,2713,2625,2675,-37,60755400,Neutral,0.0
16/07/2020,2638,2675,2625,2638,0,43859400,Neutral,0.0
17/07/2020,2588,2650,2588,2638,-50,60177000,Neutral,0.0
20/07/2020,2550,2613,2525,2588,-38,52111600,Neutral,0.0
21/07/2020,2650,2725,2538,2575,75,145051400,Neutral,0.0
22/07/2020,2713,2763,2650,2688,25,119245000,Neutral,0.0
23/07/2020,2850,2888,2713,2738,112,145829600,Neutral,0.0
24/07/2020,2800,2850,2775,2850,-50,66603400,Positive,0.5267
27/07/2020,2938,2938,2775,2813,125,58848200,Positive,"0,5406"
28/07/2020,2925,3000,2888,2950,-25,74524600,Positive,0.5574
29/07/2020,2850,2925,2838,2925,-75,69737200,Neutral,-0.0258
30/07/2020,2900,2900,2813,2863,37,52644600,Neutral,0.0
03/08/2020,2750,2938,2725,2925,-175,259720800,Negative,"-0,4346"
04/08/2020,2788,2800,2725,2763,25,89173800,Positive,"0,3599"
05/08/2020,2850,2850,2725,2775,75,133844600,Positive,"0,7885"
06/08/2020,2888,2938,2850,2850,38,90911200,Positive,"0,9303"
07/08/2020,2900,2900,2813,2850,50,57228800,Positive,"0,2559"
10/08/2020,2900,2913,2825,2900,0,50162400,Positive,"0,6664"
11/08/2020,2988,3050,2900,2913,75,117978200,Positive,"0,0272"
12/08/2020,3075,3138,2975,3000,75,92910400,Positive,"0,3929"
13/08/2020,3025,3125,3025,3125,-100,85989200,Negative,"-0,1185"
14/08/2020,3013,3050,2975,3038,-25,66653400,Negative,"-0,1607"
18/08/2020,3075,3113,3013,3013,62,115981200,Positive,"0,7552"
19/08/2020,3050,3125,3038,3088,-38,64511800,Negative,"-0,4932"
24/08/2020,3000,3088,2963,3025,-25,132486400,Negative,"-0,3021"
25/08/2020,3125,3138,3025,3025,100,132365800,Positive,"0,9348"
26/08/2020,3175,3175,3088,3125,50,78703400,Positive,"0,2015"
27/08/2020,3150,3175,3100,3175,-25,93450200,Negative,"-0,1377"
28/08/2020,3113,3175,3100,3138,-25,75655000,Negative,"-0,4963"
31/08/2020,2975,3150,2950,3113,-138,222818800,Negative,"-0,3254"
01/09/2020,3063,3063,2938,2988,75,85330800,Positive,"0,2654"
02/09/2020,3038,3100,3025,3063,-25,93203600,Negative,"-0,1124"
03/09/2020,2988,3075,2975,3038,-50,129014800,Negative,"-0,1371"
04/09/2020,2963,2988,2925,2975,-12,106844400,Negative,"-0,1738"
07/09/2020,2925,2975,2888,2963,-38,100673600,Negative,"-0,1339"
08/09/2020,2988,3000,2938,2950,38,60346000,Positive,"0,3191"
09/09/2020,2888,2950,2875,2950,-62,98282200,Negative,"-0,4939"
10/09/2020,2688,2763,2688,2763,-75,172775200,Negative,"-0,1662"
11/09/2020,2738,2763,2525,2525,213,271155800,Positive,"0,6733"
14/09/2020,2875,2888,2738,2738,137,143569800,Positive,"0,428"
15/09/2020,2838,2913,2800,2875,-37,128927400,Negative,"-0,3779"
16/09/2020,2825,2875,2813,2875,-50,57936000,Negative,"-0,3296"
17/09/2020,2788,2875,2763,2800,-12,76432000,Negative,"-0,1256"
18/09/2020,2788,2838,2750,2788,0,91596600,Positive,"0,9105"
21/09/2020,2738,2813,2700,2788,-50,52930000,Negative,"-0,4779"
22/09/2020,2650,2713,2638,2650,0,113596600,Positive,"0,6776"
23/09/2020,2600,2688,2563,2650,-50,84710800,Negative,"-0,3525"
24/09/2020,2538,2575,2500,2525,13,121965000,Positive,"0,903"
25/09/2020,2675,2675,2538,2600,75,140455600,Positive,"0,5384"
28/09/2020,2575,2713,2575,2700,-125,99702600,Negative,"-0,4858"
29/09/2020,2538,2625,2513,2600,-62,111325600,Negative,"-0,1362"
30/09/2020,2480,2575,2430,2550,-70,151529800,Negative,"-0,4437"
01/10/2020,2600,2600,2490,2500,100,78954200,Positive,"0,8949"
02/10/2020,2600,2613,2500,2588,12,99143400,Positive,"0,8388"
05/10/2020,2675,2688,2588,2625,50,74300800,Positive,"0,9662"
06/10/2020,2750,2775,2725,2750,0,89104400,Positive,"0,003"
07/10/2020,2775,2775,2688,2700,75,88748600,Positive,"0,6615"
08/10/2020,2725,2788,2713,2775,-50,88763400,Negative,"-0,1543"
09/10/2020,2775,2788,2725,2725,50,90248600,Positive,"0,2485"
12/10/2020,2813,2825,2775,2788,25,77947000,Positive,"0,9874"
13/10/2020,2838,2838,2763,2813,25,69863400,Positive,"0,5474"
14/10/2020,2888,2888,2813,2863,25,109787200,Positive,"0,6401"
15/10/2020,2800,2875,2800,2850,-50,77289200,Negative,"-0,3829"
16/10/2020,2788,2825,2725,2800,-12,67817800,Negative,"-0,376"
19/10/2020,2850,2863,2788,2800,50,58936200,Positive,"0,4389"
20/10/2020,2825,2875,2800,2863,-38,77213200,Negative,"-0,1359"
21/10/2020,2763,2863,2738,2838,-75,113901800,Negative,"-0,4397"
22/10/2020,2725,2775,2700,2750,-25,138701400,Negative,"-0,269"
23/10/2020,2775,2788,2738,2763,12,65900200,Positive,"0,2837"
26/10/2020,2888,2925,2813,2813,75,188574400,Positive,"0,7786"
27/10/2020,2888,2925,2850,2875,13,112695800,Positive,"0,8989"
02/11/2020,2988,3013,2800,2838,150,216862800,Positive,"0,7744"
03/11/2020,3000,3000,2950,2988,12,75963400,Positive,"0,4634"
04/11/2020,2850,3013,2850,2975,-125,152817400,Negative,"-0,2033"
05/11/2020,2988,3000,2913,2938,50,175877400,Positive,"0,5957"
06/11/2020,3025,3050,2963,2988,37,164219000,Positive,"0,1271"
09/11/2020,3075,3150,3025,3125,-50,122653200,Negative,"-0,3016"
10/11/2020,3188,3263,3150,3200,-12,249588800,Negative,"-0,4863"
11/11/2020,3188,3250,3175,3213,-25,166490200,Negative,"-0,474"
12/11/2020,3088,3200,3050,3188,-100,136150600,Negative,"-0,1963"
13/11/2020,3125,3125,3038,3050,75,122043800,Positive,"0,4282"
16/11/2020,3100,3225,3075,3150,-50,133917600,Negative,"-0,3202"
17/11/2020,3125,3188,3100,3138,-13,106261600,Negative,"-0,3335"
18/11/2020,3175,3175,3075,3075,100,124936000,Positive,"0,4363"
19/11/2020,3163,3175,3100,3125,38,94808200,Positive,"0,0742"
20/11/2020,3150,3175,3125,3138,12,100573600,Positive,"0,0764"
23/11/2020,3200,3213,3138,3150,50,106905400,Positive,"0,5247"
24/11/2020,3213,3250,3188,3225,-12,140929200,Negative,"-0,4544"
25/11/2020,3263,3325,3250,3250,13,197704000,Positive,"0,3367"
26/11/2020,3363,3363,3275,3300,63,132275400,Positive,"0,1986"
27/11/2020,3325,3400,3313,3388,-63,124346800,Negative,"-0,1832"
30/11/2020,3163,3313,3113,3275,-112,307900800,Negative,"-0,3207"
01/12/2020,3263,3313,3163,3163,100,176568000,Positive,"0,2074"
02/12/2020,3325,3325,3238,3263,62,114721600,Positive,"0,9347"
03/12/2020,3288,3338,3263,3325,-37,155342400,Negative,"-0,3482"
04/12/2020,3300,3300,3213,3250,50,74976000,Positive,"0,9063"
07/12/2020,3350,3375,3313,3338,12,133585800,Positive,"0,6847"
08/12/2020,3338,3363,3300,3338,0,70350400,Positive,"0,0734"
10/12/2020,3400,3425,3363,3388,12,187847000,Positive,"0,7661"
11/12/2020,3388,3438,3350,3425,-37,94541800,Negative,"-0,2508"
14/12/2020,3363,3400,3338,3363,0,94645200,Positive,"0,7687"
15/12/2020,3350,3363,3300,3350,0,135663800,Positive,"0,9509"
16/12/2020,3388,3413,3363,3400,-12,97361800,Negative,"-0,1297"
17/12/2020,3438,3438,3388,3388,50,109966000,Positive,"0,6895"
18/12/2020,3350,3413,3350,3400,-50,142797800,Negative,"-0,1398"
21/12/2020,3350,3400,3338,3388,-38,83174600,Negative,"-0,439"
22/12/2020,3200,3313,3175,3288,-88,165929800,Negative,"-0,2494"
23/12/2020,3175,3300,3100,3250,-75,110032400,Negative,"-0,4473"
28/12/2020,3263,3288,3150,3250,13,75527000,Positive,"0,6942"
29/12/2020,3213,3300,3200,3288,-75,57422600,Negative,"-0,3887"
30/12/2020,3163,3263,3163,3263,-100,88941400,Negative,"-0,3524"
04/01/2021,3250,3263,3113,3175,75,61058000,Positive,"0,4367"
05/01/2021,3213,3275,3200,3275,-62,69928200,Negative,"-0,2685"
06/01/2021,3213,3263,3138,3213,0,87109000,Positive,"0,0111"
07/01/2021,3238,3263,3213,3225,13,80114200,Positive,"0,2558"
08/01/2021,3275,3288,3225,3238,37,93635600,Positive,"0,1245"
11/01/2021,3425,3425,3275,3288,137,212763000,Positive,"0,0166"
12/01/2021,3475,3500,3413,3450,25,168626000,Positive,"0,2446"
13/01/2021,3463,3538,3463,3525,-62,107392200,Negative,"-0,2421"
14/01/2021,3425,3525,3413,3525,-100,70295000,Negative,"-0,2925"
15/01/2021,3363,3463,3313,3438,-75,77235600,Negative,"-0,3838"
18/01/2021,3463,3475,3300,3300,163,119006800,Positive,"0,0873"
19/01/2021,3488,3513,3425,3500,-12,77834600,Negative,"-0,1822"
20/01/2021,3688,3725,3500,3500,188,220934600,Positive,"0,5765"
21/01/2021,3625,3688,3600,3688,-63,82052000,Negative,"-0,3146"
22/01/2021,3600,3675,3563,3638,-38,117367200,Negative,"-0,4417"
25/01/2021,3650,3650,3513,3625,25,100647600,Positive,"0,822"
26/01/2021,3688,3725,3625,3650,38,206712400,Positive,"0,3558"
27/01/2021,3650,3700,3588,3700,-50,171581400,Negative,"-0,4963"
28/01/2021,3525,3625,3450,3575,-50,135745000,Negative,"-0,2575"
29/01/2021,3288,3613,3288,3550,-262,334227600,Negative,"-0,4145"
01/02/2021,3350,3363,3100,3325,25,242540200,Positive,"0,4647"
02/02/2021,3238,3400,3200,3400,-162,160482800,Negative,"-0,1881"
03/02/2021,3250,3325,3225,3300,-50,167044600,Negative,"-0,3857"
04/02/2021,3288,3338,3225,3288,0,139040400,Positive,"0,809"
05/02/2021,3275,3350,3225,3350,-75,97199600,Negative,"-0,2514"
08/02/2021,3288,3338,3275,3300,-12,125050800,Negative,"-0,3265"
09/02/2021,3250,3350,3225,3300,-50,208380400,Negative,"-0,4989"
10/02/2021,3250,3288,3238,3288,-38,102693600,Negative,"-0,2405"
11/02/2021,3250,3275,3250,3275,-25,35879400,Negative,"-0,3878"
15/02/2021,3250,3288,3250,3275,-25,48995200,Negative,"-0,426"
16/02/2021,3238,3275,3225,3250,-12,63202000,Negative,"-0,3682"
17/02/2021,3175,3238,3150,3225,-50,117413600,Negative,"-0,365"
18/02/2021,3125,3200,3113,3125,0,113989000,Positive,"0,1273"
19/02/2021,3188,3200,3100,3125,63,102020400,Positive,"0,7443"
22/02/2021,3188,3250,3188,3225,-37,107680600,Negative,"-0,4865"
23/02/2021,3163,3188,3150,3150,13,89107800,Positive,"0,5876"
24/02/2021,3188,3200,3163,3175,13,82498600,Positive,"0,1325"
25/02/2021,3138,3238,3138,3213,-75,133614800,Negative,"-0,2492"
26/02/2021,3075,3163,3050,3088,-13,246190600,Negative,"-0,3856"
01/03/2021,3288,3300,3113,3113,175,220785400,Positive,"0,4438"
02/03/2021,3300,3325,3250,3325,-25,163296600,Negative,"-0,1925"
03/03/2021,3300,3338,3263,3338,-38,78532200,Negative,"-0,2681"
04/03/2021,3275,3325,3263,3313,-38,120612600,Negative,"-0,4907"
05/03/2021,3238,3288,3225,3263,-25,87239000,Negative,"-0,3943"
08/03/2021,3213,3288,3188,3275,-62,54098000,Negative,"-0,1234"
09/03/2021,3213,3263,3188,3188,25,111838800,Positive,"0,7379"
10/03/2021,3250,3250,3225,3250,0,51903000,Positive,"0,6862"
12/03/2021,3363,3375,3275,3275,88,159202400,Positive,"0,9237"
15/03/2021,3325,3388,3313,3388,-63,79922400,Negative,"-0,4364"
16/03/2021,3275,3363,3250,3325,-50,112248400,Negative,"-0,3937"
17/03/2021,3263,3325,3263,3300,-37,50841200,Negative,"-0,129"
18/03/2021,3400,3425,3313,3313,87,152427600,Positive,"0,8543"
19/03/2021,3388,3400,3350,3400,-12,150713800,Negative,"-0,3068"
22/03/2021,3313,3413,3313,3375,-62,115979200,Negative,"-0,2366"
23/03/2021,3338,3375,3313,3375,-37,97289600,Negative,"-0,1905"
24/03/2021,3213,3263,3200,3250,-37,115254200,Negative,"-0,308"
25/03/2021,3200,3238,3163,3225,-25,71666600,Negative,"-0,1676"
26/03/2021,3213,3238,3175,3225,-12,84478000,Negative,"-0,2662"
29/03/2021,3188,3250,3188,3200,-12,79520400,Negative,"-0,4328"
30/03/2021,3163,3213,3138,3200,-37,41180600,Negative,"-0,3722"
31/03/2021,3075,3163,3063,3125,-50,159155800,Negative,"-0,3871"
01/04/2021,3100,3163,3075,3125,-25,77715200,Negative,"-0,4457"
05/04/2021,3113,3150,3100,3150,-37,39468400,Negative,"-0,1903"
06/04/2021,3138,3150,3075,3113,25,29650600,Positive,"0,5378"
07/04/2021,3163,3163,3125,3150,13,46420200,Positive,"0,1366"
08/04/2021,3138,3188,3100,3125,13,88449600,Positive,"0,6174"
09/04/2021,3238,3275,3163,3188,50,126420200,Positive,"0,4168"
12/04/2021,3150,3250,3138,3213,-63,48429000,Negative,"-0,1003"
13/04/2021,3150,3175,3100,3100,50,76327000,Positive,"0,611"
14/04/2021,3163,3200,3125,3175,-12,80914000,Negative,"-0,277"
15/04/2021,3150,3200,3113,3200,-50,68337400,Negative,"-0,2759"
16/04/2021,3150,3175,3125,3175,-25,63194400,Negative,"-0,1198"
19/04/2021,3113,3138,3100,3125,-12,43598600,Negative,"-0,4114"
20/04/2021,3100,3125,3088,3100,0,63882600,Positive,"0,4476"
21/04/2021,3063,3088,3063,3075,-12,65425600,Negative,"-0,1877"
22/04/2021,3063,3113,3050,3088,-25,71452000,Negative,"-0,3813"
23/04/2021,3075,3075,3013,3025,50,104928400,Positive,"0,0979"
26/04/2021,2988,3063,2975,3050,-62,115305000,Negative,"-0,1673"
27/04/2021,3025,3038,2975,2988,37,96850800,Positive,"0,2765"
28/04/2021,3100,3138,3050,3050,50,161162600,Positive,"0,0658"
29/04/2021,3113,3138,3075,3113,0,82870600,Positive,"0,7044"
30/04/2021,3088,3125,3063,3113,-25,69941600,Negative,"-0,197"
03/05/2021,3025,3075,3000,3050,-25,65334000,Negative,"-0,4704"
04/05/2021,3050,3050,2988,3025,25,56355200,Positive,"0,0591"
05/05/2021,3025,3075,3025,3075,-50,45851800,Negative,"-0,2212"
06/05/2021,3038,3063,3013,3063,-25,37091000,Negative,"-0,391"
07/05/2021,2975,3063,2975,3063,-88,65331800,Negative,"-0,2023"
10/05/2021,2988,3013,2975,3013,-25,35481400,Negative,"-0,1481"
11/05/2021,2950,3000,2925,3000,-50,69381800,Negative,"-0,124"
17/05/2021,2963,3000,2938,2988,-25,95099800,Negative,"-0,2581"
18/05/2021,2950,3000,2913,2988,-38,73965200,Negative,"-0,4523"
19/05/2021,2838,2925,2813,2900,-62,98436000,Negative,"-0,3018"
20/05/2021,2825,2875,2800,2825,0,69610000,Positive,"0,0263"
21/05/2021,2913,2950,2838,2863,50,140453000,Positive,"0,9015"
24/05/2021,2875,2938,2875,2938,-63,54897600,Negative,"-0,2163"
25/05/2021,2950,2975,2888,2888,62,90594400,Positive,"0,2454"
27/05/2021,2875,3000,2875,3000,-125,353889800,Negative,"-0,1022"
28/05/2021,2900,2950,2888,2913,-13,78305800,Negative,"-0,134"
31/05/2021,3000,3050,2913,2938,62,96660000,Positive,"0,2719"
02/06/2021,3050,3100,3038,3075,-25,157335600,Negative,"-0,2065"
03/06/2021,3125,3138,3063,3088,37,86426400,Positive,"0,3259"
04/06/2021,3063,3163,3063,3125,-62,76307800,Negative,"-0,1694"
07/06/2021,3063,3100,3038,3100,-37,42514400,Negative,"-0,4001"
08/06/2021,3000,3075,3000,3075,-75,57084000,Negative,"-0,3543"
09/06/2021,3075,3088,3000,3038,37,47078600,Positive,"0,7125"
10/06/2021,3100,3125,3063,3088,12,43543600,Positive,"0,4729"
11/06/2021,3138,3150,3113,3138,0,77757800,Positive,"0,6053"
14/06/2021,3138,3150,3113,3150,-12,50043400,Negative,"-0,3543"
15/06/2021,3163,3163,3113,3150,13,107187800,Positive,"0,5403"
16/06/2021,3138,3175,3100,3163,-25,90051600,Negative,"-0,2578"
17/06/2021,3100,3138,3100,3125,-25,146517200,Negative,"-0,1344"
18/06/2021,3100,3100,2975,3088,12,201335400,Positive,"0,029"
21/06/2021,3013,3050,2975,3050,-37,138949200,Negative,"-0,2986"
22/06/2021,3088,3125,3013,3038,50,96680600,Positive,"0,4497"
23/06/2021,3013,3113,3013,3113,-100,66074200,Negative,"-0,3195"
24/06/2021,2988,3050,2988,3050,-62,52248000,Negative,"-0,2749"
25/06/2021,2950,3013,2950,3000,-50,61052000,Negative,"-0,3882"
28/06/2021,2850,2950,2838,2913,-63,127109000,Negative,"-0,197"
29/06/2021,2888,2925,2850,2925,-37,96970800,Negative,"-0,3406"
30/06/2021,2950,2975,2900,2925,25,146560200,Positive,"0,3434"
01/07/2021,2988,3000,2950,2975,13,87385400,Positive,"0,7291"
02/07/2021,2975,3013,2963,2988,-13,80422400,Negative,"-0,1999"
05/07/2021,2925,2988,2900,2988,-63,29242400,Negative,"-0,4059"
06/07/2021,2888,2950,2875,2950,-62,56066200,Negative,"-0,2405"
07/07/2021,2875,2913,2838,2888,-13,96691000,Negative,"-0,2347"
08/07/2021,2950,2950,2875,2925,25,81459000,Positive,"0,8307"
09/07/2021,2888,2950,2888,2950,-62,50822400,Negative,"-0,165"
12/07/2021,2900,2938,2888,2938,-38,39692600,Negative,"-0,1444"
13/07/2021,2888,2950,2888,2925,-37,65117000,Negative,"-0,1735"
14/07/2021,2850,2913,2825,2900,-50,59225200,Negative,"-0,2135"
15/07/2021,2938,2950,2838,2863,75,94438400,Positive,"0,7989"
16/07/2021,2938,2950,2913,2938,0,39567600,Positive,"0,1683"
19/07/2021,2875,2925,2875,2900,-25,31460200,Negative,"-0,3801"
21/07/2021,2963,2975,2900,2913,50,87100200,Positive,"0,686"
22/07/2021,3025,3050,2975,2988,37,55171400,Positive,"0,019"
23/07/2021,2988,3025,2975,3000,-12,37457600,Negative,"-0,2745"
26/07/2021,2900,3000,2900,2988,-88,77160200,Neutral,0.0
27/07/2021,2913,2950,2875,2925,-12,79279400,Neutral,0.0
28/07/2021,2950,2950,2875,2875,75,41266000,Positive,0.4215
29/07/2021,2875,2950,2875,2950,-75,68168400,Neutral,0.0
30/07/2021,2850,2913,2850,2913,-63,92132400,Neutral,0.0
02/08/2021,2838,2888,2813,2888,-50,68571000,Negative,"-0,1361"
03/08/2021,2888,2900,2825,2850,38,70957400,Neutral,0.0
04/08/2021,2913,2950,2888,2913,0,67410400,Positive,0.1531
05/08/2021,3025,3038,2925,2938,87,140254000,Neutral,0.0
06/08/2021,2988,3050,2975,3038,-50,63682000,Neutral,0.0
09/08/2021,2900,3013,2900,3000,-100,50317400,Neutral,0.0
10/08/2021,2900,2938,2888,2900,0,54893400,Neutral,0.0
12/08/2021,2963,2975,2913,2938,25,51328800,Neutral,0.0
13/08/2021,3000,3025,2950,2988,12,41771600,Neutral,0.0
16/08/2021,2988,3025,2925,3000,-12,53074000,Neutral,0.0
18/08/2021,3025,3088,2963,3000,25,141229400,Neutral,0.0
19/08/2021,2925,3050,2900,3050,-125,101976800,Neutral,0.0
20/08/2021,2950,2975,2900,2950,0,62841600,Positive,"0,8052"
23/08/2021,2988,3000,2950,2950,38,46346200,Positive,0.1531
24/08/2021,2913,2988,2900,2975,-62,85217600,Negative,"-0,2871"
25/08/2021,2975,2988,2925,2938,37,60726800,Neutral,0.0
26/08/2021,2913,2963,2913,2925,-12,55050200,Positive,0.4404
27/08/2021,2900,2938,2888,2913,-13,35765000,Neutral,0.0
30/08/2021,2975,2975,2913,2925,50,65062000,Neutral,0.0
31/08/2021,3050,3050,2975,3000,50,135700400,Neutral,0.0
01/09/2021,3000,3050,3000,3050,-50,70082000,Positive,0.5423
02/09/2021,3025,3050,2988,3025,0,51554400,Neutral,0.0
03/09/2021,3063,3075,3000,3050,13,50760000,Positive,0.6124
06/09/2021,3100,3163,3063,3100,0,51684400,Neutral,0.0
07/09/2021,3125,3175,3113,3125,0,70448400,Positive,0.4404
08/09/2021,3125,3150,3063,3150,-25,84660600,Neutral,0.0
09/09/2021,3175,3175,3063,3150,25,93331600,Neutral,0.0
10/09/2021,3100,3150,3088,3138,-38,107576800,Neutral,0.0
13/09/2021,3075,3113,3025,3050,25,104806600,Neutral,0.0
14/09/2021,3050,3100,3038,3075,-25,84931400,Positive,0.1779
15/09/2021,3063,3100,3050,3088,-25,135497800,Neutral,0.0
16/09/2021,3075,3100,3063,3088,-13,61344200,Positive,0.2023
17/09/2021,3025,3075,3025,3063,-38,82452800,Neutral,0.0
20/09/2021,3013,3038,2963,3013,0,57569200,Neutral,0.0
21/09/2021,2988,3013,2963,3013,-25,45153400,Neutral,0.0
22/09/2021,3038,3050,2975,2988,50,26711200,Positive,"0,6896"
23/09/2021,3038,3063,3013,3063,-25,40606000,Positive,0.4215
24/09/2021,2988,3050,2963,3038,-50,50278400,Neutral,0.0
27/09/2021,2950,3013,2950,3000,-50,68500800,Positive,0.5095
28/09/2021,2975,3013,2950,2975,0,64652200,Neutral,0.0
29/09/2021,3000,3025,2963,2975,25,56467400,Positive,0.2023
30/09/2021,3075,3075,3000,3025,50,82812000,Negative,-0.1779
01/10/2021,3050,3100,3025,3075,-25,74975400,Neutral,0.0
04/10/2021,3238,3250,3075,3088,150,156691600,Positive,0.34
05/10/2021,3213,3275,3188,3225,-12,94886200,Neutral,0.0
06/10/2021,3300,3338,3225,3238,62,168775800,Neutral,0.0
07/10/2021,3350,3413,3313,3325,25,253196600,Neutral,0.0
08/10/2021,3450,3488,3363,3363,87,223592000,Neutral,0.0
11/10/2021,3450,3463,3400,3450,0,123020200,Positive,0.3818
12/10/2021,3500,3525,3463,3488,12,191044200,Negative,-0.6249
13/10/2021,3550,3550,3475,3538,12,134998000,Positive,0.2263
14/10/2021,3588,3588,3525,3563,25,104307800,Neutral,0.0
15/10/2021,3575,3600,3538,3588,-13,84353000,Neutral,0.0
18/10/2021,3588,3663,3575,3600,-12,152951600,Neutral,0.0
19/10/2021,3600,3625,3525,3625,-25,99358000,Neutral,0.0
21/10/2021,3588,3663,3563,3588,0,189264000,Neutral,0.0
22/10/2021,3600,3613,3538,3550,50,65782600,Neutral,0.0
25/10/2021,3563,3625,3563,3588,-25,76296200,Positive,0.4939
26/10/2021,3588,3600,3550,3550,38,55872800,Neutral,0.0
27/10/2021,3575,3613,3563,3600,-25,82925200,Neutral,0.0
28/10/2021,3513,3575,3500,3563,-50,99023600,Positive,0.2023
29/10/2021,3588,3650,3575,3588,0,160952400,Positive,0.2023
01/11/2021,3588,3625,3575,3625,-37,65621400,Neutral,0.0
02/11/2021,3513,3600,3500,3588,-75,51923400,Neutral,0.0
03/11/2021,3563,3625,3463,3488,75,107556600,Neutral,0.0
04/11/2021,3588,3650,3588,3625,-37,103726400,Neutral,0.0
05/11/2021,3550,3625,3500,3625,-75,48035600,Neutral,0.0
08/11/2021,3500,3600,3500,3600,-100,50517400,Neutral,0.0
09/11/2021,3438,3550,3425,3525,-87,120574200,Neutral,0.0
10/11/2021,3575,3575,3438,3438,137,156118000,Neutral,0.0
11/11/2021,3613,3613,3513,3563,50,86362400,Positive,0.4404
12/11/2021,3550,3638,3525,3638,-88,56807000,Neutral,0.0
15/11/2021,3525,3575,3525,3550,-25,40131000,Neutral,0.0
16/11/2021,3613,3613,3513,3525,88,76140200,Neutral,0.0
17/11/2021,3613,3625,3575,3613,0,72789600,Positive,0.4588
18/11/2021,3588,3613,3575,3600,-12,30911600,Positive,0.4588
19/11/2021,3625,3650,3575,3588,37,101125800,Positive,0.4588
22/11/2021,3675,3750,3613,3675,0,92374400,Neutral,0.0
23/11/2021,3575,3638,3550,3613,-38,63127600,Neutral,0.0
24/11/2021,3575,3588,3550,3563,12,56217000,Positive,0.5994
25/11/2021,3675,3688,3588,3613,62,97473400,Neutral,0.0
26/11/2021,3550,3663,3538,3663,-113,78633400,Neutral,0.0
29/11/2021,3588,3638,3463,3550,38,112673000,Neutral,0.0
30/11/2021,3500,3625,3475,3625,-125,219340400,Neutral,0.0
01/12/2021,3538,3563,3475,3500,38,93119800,Neutral,0.0
02/12/2021,3600,3625,3500,3538,62,70416400,Neutral,0.0
03/12/2021,3575,3613,3550,3600,-25,46109400,Neutral,0.0
06/12/2021,3588,3625,3550,3575,13,52050400,Neutral,0.0
07/12/2021,3650,3650,3588,3588,62,64289400,Positive,0.9042
08/12/2021,3575,3650,3575,3638,-63,56064200,Neutral,0.0
09/12/2021,3675,3675,3563,3625,50,42688600,Positive,0.2732
10/12/2021,3600,3613,3550,3600,0,93532200,Neutral,0.0
13/12/2021,3563,3613,3563,3600,-37,50091200,Positive,0.0772
14/12/2021,3588,3600,3550,3563,25,65061400,Neutral,0.0
15/12/2021,3638,3663,3563,3575,63,75677400,Positive,"0,8522"
16/12/2021,3625,3663,3600,3650,-25,69082400,Negative,"-0,3498"
17/12/2021,3575,3613,3538,3613,-38,83945200,Neutral,0.0
20/12/2021,3538,3575,3538,3550,-12,57932600,Negative,-0.4019
21/12/2021,3575,3625,3550,3575,0,49859600,Positive,0.4215
22/12/2021,3525,3600,3525,3588,-63,34814400,Positive,0.2023
23/12/2021,3538,3575,3525,3525,13,44565000,Neutral,0.0
24/12/2021,3525,3575,3475,3550,-25,54902200,Positive,0.1779
27/12/2021,3500,3550,3488,3525,-25,34096400,Negative,"-0,2135"
28/12/2021,3525,3525,3488,3525,0,39835400,Neutral,0.0
29/12/2021,3550,3563,3500,3538,12,20860200,Positive,0.4939
30/12/2021,3513,3563,3513,3550,-37,34951600,Negative,"-0,4382"
03/01/2022,3525,3563,3513,3550,-25,30999600,Negative,"-0,1784"
04/01/2022,3588,3600,3525,3538,50,44541400,Positive,"0,5318"
05/01/2022,3513,3588,3463,3575,-62,98910200,Negative,"-0,4163"
06/01/2022,3513,3538,3475,3538,-25,65651200,Negative,"-0,3914"
07/01/2022,3525,3550,3513,3513,12,68452800,Positive,"0,2676"
10/01/2022,3525,3550,3525,3538,-13,44378600,Negative,"-0,2256"
11/01/2022,3525,3550,3500,3550,-25,50367600,Negative,"-0,4831"
12/01/2022,3575,3575,3525,3525,50,34249200,Positive,"0,8407"
13/01/2022,3563,3588,3550,3575,-12,35763800,Negative,"-0,1917"
14/01/2022,3588,3613,3538,3538,50,43651400,Positive,"0,6804"
17/01/2022,3600,3638,3575,3625,-25,43188000,Negative,"-0,4745"
18/01/2022,3625,3625,3550,3588,37,64484800,Positive,"0,7679"
19/01/2022,3513,3600,3500,3588,-75,103093600,Negative,"-0,1627"
20/01/2022,3588,3588,3513,3550,38,53067000,Positive,"0,1517"
21/01/2022,3650,3650,3563,3588,62,76806800,Positive,"0,8763"
24/01/2022,3638,3638,3600,3638,0,44476800,Positive,"0,8051"
25/01/2022,3613,3625,3575,3600,13,69268000,Positive,"0,065"
26/01/2022,3738,3738,3613,3650,88,140636400,Positive,"0,7759"
27/01/2022,3775,3800,3700,3738,37,113618000,Positive,"0,0378"
28/01/2022,3825,3825,3775,3813,12,121145200,Positive,"0,4742"
31/01/2022,3738,3888,3725,3888,-150,101700800,Negative,"-0,4347"
02/02/2022,3738,3763,3725,3763,-25,68769000,Negative,"-0,1646"
03/02/2022,3738,3738,3675,3738,0,60204000,Positive,"0,2111"
04/02/2022,3738,3763,3700,3725,13,36629400,Positive,"0,8022"
07/02/2022,3750,3825,3738,3825,-75,68867800,Negative,"-0,3354"
08/02/2022,3813,3863,3775,3800,13,158581800,Positive,"0,0074"
09/02/2022,3838,3863,3800,3850,-12,107360800,Negative,"-0,4001"
10/02/2022,3863,3875,3825,3850,13,107679400,Positive,"0,9518"
11/02/2022,3863,3888,3825,3888,-25,81582600,Negative,"-0,2493"
14/02/2022,3900,3900,3813,3850,50,76263200,Positive,"0,2137"
15/02/2022,3950,3950,3838,3900,50,67804400,Positive,"0,9522"
16/02/2022,3925,3963,3875,3963,-38,74785000,Negative,"-0,3085"
17/02/2022,3925,3938,3838,3938,-13,103038800,Negative,"-0,1985"
18/02/2022,3925,3975,3875,3913,12,81303200,Positive,"0,3343"
21/02/2022,3925,3963,3925,3925,0,31720800,Positive,"0,669"
22/02/2022,3938,3950,3888,3913,25,69476600,Positive,"0,1296"
23/02/2022,3938,3975,3913,3963,-25,85991000,Negative,"-0,3048"
24/02/2022,3850,3938,3825,3863,-13,170297000,Negative,"-0,4236"
25/02/2022,3850,3875,3825,3863,-13,163299800,Negative,"-0,226"
01/03/2022,3825,3925,3825,3838,-13,149532200,Negative,"-0,1776"
02/03/2022,3813,3863,3775,3825,-12,110824000,Negative,"-0,2417"
04/03/2022,3825,3863,3800,3850,-25,104914600,Negative,"-0,4068"
07/03/2022,3775,3813,3750,3775,0,137667600,Positive,"0,3122"
08/03/2022,3775,3850,3775,3813,-38,104072200,Negative,"-0,276"
09/03/2022,3813,3863,3788,3788,25,115109200,Positive,"0,0187"
10/03/2022,3838,3875,3800,3850,-12,105803000,Negative,"-0,4372"
11/03/2022,3825,3863,3800,3863,-38,122401600,Negative,"-0,1282"
14/03/2022,3875,3913,3813,3825,50,173513400,Positive,"0,2683"
15/03/2022,3888,3938,3888,3900,-12,146735400,Negative,"-0,3932"
16/03/2022,3975,4025,3900,3900,75,291909800,Positive,"0,628"
17/03/2022,3975,4050,3975,4000,-25,235559000,Negative,"-0,1867"
18/03/2022,3963,4000,3938,3988,-25,212233400,Negative,"-0,1281"
21/03/2022,3825,3863,3800,3838,-13,162364400,Negative,"-0,1019"
22/03/2022,3838,3875,3825,3850,-12,112672400,Negative,"-0,4137"
23/03/2022,3888,3900,3825,3838,50,183894800,Positive,"0,2239"
24/03/2022,3963,3963,3850,3850,113,210909800,Positive,"0,3714"
25/03/2022,3925,3988,3888,3975,-50,136083000,Negative,"-0,286"
28/03/2022,3938,3950,3900,3938,0,95354400,Positive,"0,6377"
29/03/2022,3963,4013,3938,3988,-25,160112200,Negative,"-0,4228"
30/03/2022,3938,3988,3925,3975,-37,82476000,Negative,"-0,292"
31/03/2022,3950,3988,3925,3963,-13,69174000,Negative,"-0,454"
01/04/2022,3938,3950,3888,3950,-12,62912400,Negative,"-0,3381"
04/04/2022,3913,3950,3888,3913,0,82013800,Positive,"0,2012"
05/04/2022,3913,3938,3900,3900,13,82378200,Positive,"0,2873"
06/04/2022,3838,3900,3825,3900,-62,129476400,Negative,"-0,4856"
07/04/2022,3850,3888,3813,3838,12,136162800,Positive,"0,0131"
08/04/2022,3850,3900,3838,3900,-50,94622400,Negative,"-0,2034"
11/04/2022,3838,3875,3825,3850,-12,107966400,Negative,"-0,278"
12/04/2022,3850,3875,3813,3838,12,92691200,Positive,"0,1874"
13/04/2022,3863,3875,3825,3838,25,90558600,Positive,"0,888"
14/04/2022,3838,3875,3825,3863,-25,63275600,Negative,"-0,4749"
18/04/2022,3813,3863,3788,3838,-25,101496000,Negative,"-0,218"
19/04/2022,3788,3838,3788,3813,-25,104508400,Negative,"-0,2003"
20/04/2022,3925,3950,3813,3825,100,164354800,Positive,"0,3974"
21/04/2022,4150,4200,3963,4000,150,337363200,Positive,"0,5019"
22/04/2022,4138,4163,4038,4100,38,168301800,Positive,"0,631"
25/04/2022,4113,4225,4013,4100,13,179082600,Positive,"0,1953"
26/04/2022,4175,4213,4113,4125,50,131930600,Positive,"0,3781"
27/04/2022,4113,4213,4113,4138,-25,118272800,Negative,"-0,4537"
28/04/2022,4475,4538,4338,4388,87,443163800,Positive,"0,1986"
09/05/2022,4163,4338,4163,4313,-150,351637800,Negative,"-0,1858"
10/05/2022,4050,4088,3913,3913,137,498444800,Positive,"0,7882"
11/05/2022,4000,4100,4000,4050,-50,198922600,Negative,"-0,4256"
12/05/2022,3938,4025,3863,3988,-50,162727200,Negative,"-0,233"
13/05/2022,3900,3950,3875,3938,-38,165507800,Negative,"-0,2689"
17/05/2022,3925,4000,3900,3900,25,149548800,Positive,"0,294"
18/05/2022,3950,4013,3900,3988,-38,162519200,Negative,"-0,3885"
19/05/2022,3950,3963,3875,3900,50,127740400,Positive,"0,6849"
20/05/2022,4000,4025,3975,3975,25,106866400,Positive,"0,6118"
23/05/2022,3938,4038,3900,4025,-87,144005200,Negative,"-0,1692"
24/05/2022,3963,4025,3950,3975,-12,134555000,Negative,"-0,1272"
25/05/2022,3925,4025,3913,3950,-25,132635400,Negative,"-0,4709"
27/05/2022,4050,4063,3975,4000,50,155078600,Positive,"0,33"
30/05/2022,4100,4100,4000,4100,0,117617200,Positive,"0,4045"
31/05/2022,4250,4250,4113,4138,112,262054000,Positive,"0,7202"
02/06/2022,4100,4175,4025,4163,-63,203021800,Negative,"-0,1876"
03/06/2022,4100,4150,4100,4138,-38,147960000,Negative,"-0,3051"
06/06/2022,4075,4175,4013,4100,-25,148785000,Negative,"-0,1802"
07/06/2022,4150,4175,4075,4100,50,132673800,Positive,"0,3947"
08/06/2022,4200,4213,4075,4113,87,153409200,Positive,"0,0623"
09/06/2022,4213,4250,4175,4200,13,216804400,Positive,"0,7674"
10/06/2022,4088,4163,4075,4138,-50,165119600,Negative,"-0,114"
13/06/2022,4050,4050,3975,4000,50,122467200,Positive,"0,0369"
14/06/2022,4100,4100,4000,4000,100,100136600,Positive,"0,1326"
15/06/2022,4150,4163,4063,4063,87,142400800,Positive,"0,0821"
16/06/2022,4188,4250,4150,4250,-62,186692600,Neutral,0.0
17/06/2022,4038,4125,4038,4088,-50,156836200,Positive,0.5106
20/06/2022,4125,4125,4025,4050,75,74978200,Neutral,0.0
21/06/2022,4125,4175,4100,4150,-25,62996600,Neutral,0.0
22/06/2022,4075,4138,4063,4100,-25,88306600,Neutral,0.0
23/06/2022,4075,4113,4050,4075,0,48817400,Neutral,0.0
24/06/2022,4150,4150,4075,4100,50,60638400,Neutral,0.0
27/06/2022,4113,4200,4038,4200,-87,76574400,Positive,0.2023
28/06/2022,4063,4100,4000,4075,-12,110131200,Negative,"-0,4426"
29/06/2022,3975,4063,3975,4050,-75,113216400,Negative,"-0,1444"
30/06/2022,3963,4050,3950,4000,-37,125507600,Neutral,0.0
01/07/2022,3800,3963,3788,3938,-138,191672200,Neutral,0.0
04/07/2022,3700,3838,3638,3788,-88,246417000,Neutral,0.0
05/07/2022,3825,3863,3725,3725,100,90919800,Negative,-0.3612
06/07/2022,3763,3825,3675,3825,-62,180812800,Neutral,0.0
07/07/2022,3713,3775,3713,3750,-37,120444800,Neutral,0.0
08/07/2022,3738,3775,3700,3775,-37,57156600,Neutral,0.0
11/07/2022,3738,3763,3700,3738,0,22860800,Negative,-0.296
12/07/2022,3713,3738,3688,3738,-25,51524400,Negative,"-0,499"
13/07/2022,3638,3713,3638,3700,-62,142494200,Neutral,0.0
14/07/2022,3638,3688,3600,3625,13,158438200,Neutral,0.0
15/07/2022,3588,3700,3588,3650,-62,191949400,Neutral,0.0
18/07/2022,3675,3675,3613,3613,62,152078400,Positive,"0,2887"
19/07/2022,3713,3725,3638,3675,38,128963600,Positive,"0,4086"
20/07/2022,3950,3975,3775,3775,175,215712600,Neutral,0.0
21/07/2022,3950,4000,3863,4000,-50,125699200,Neutral,0.0
22/07/2022,3925,3963,3888,3963,-38,54461200,Positive,0.34
25/07/2022,3888,3950,3888,3938,-50,30750600,Neutral,0.0
26/07/2022,4000,4013,3900,3913,87,58317600,Neutral,0.0
27/07/2022,4050,4063,4000,4025,25,87439200,Positive,0.25
28/07/2022,4025,4100,4013,4013,12,94427400,Neutral,0.0
29/07/2022,4138,4175,4075,4113,25,132709400,Neutral,0.0
01/08/2022,3988,4113,3988,4100,-112,95909000,Positive,0.2263
02/08/2022,4088,4088,3988,4000,88,57458200,Positive,0.1779
03/08/2022,4125,4125,4025,4088,37,55822800,Positive,0.2732
04/08/2022,4125,4150,4075,4150,-25,75188600,Positive,0.1779
05/08/2022,4125,4150,4088,4138,-13,64150800,Neutral,0.0
08/08/2022,4175,4175,4113,4125,50,82522000,Neutral,0.0
09/08/2022,4238,4300,4200,4213,25,117148200,Neutral,0.0
10/08/2022,4300,4300,4125,4175,125,79950200,Neutral,0.0
11/08/2022,4263,4338,4213,4313,-50,106627400,Positive,0.4939
12/08/2022,4238,4288,4213,4263,-25,62626200,Neutral,0.0
15/08/2022,4225,4275,4200,4225,0,44464800,Neutral,0.0
16/08/2022,4263,4325,4238,4275,-12,109260400,Neutral,0.0
18/08/2022,4300,4400,4288,4388,-88,116693200,Neutral,0.0
19/08/2022,4250,4325,4250,4300,-50,48290200,Positive,0.296
22/08/2022,4263,4275,4175,4213,50,121399800,Neutral,0.0
23/08/2022,4313,4338,4225,4250,63,95553400,Neutral,0.0
24/08/2022,4313,4350,4275,4300,13,60958200,Neutral,0.0
25/08/2022,4288,4313,4213,4275,13,77254800,Neutral,0.0
26/08/2022,4250,4325,4250,4313,-63,82356600,Positive,0.1779
29/08/2022,4275,4300,4175,4200,75,62683800,Positive,"0,0555"
30/08/2022,4325,4375,4288,4313,12,109649400,Positive,"0,9179"
31/08/2022,4425,4425,4225,4250,175,151631600,Positive,"0,9311"
01/09/2022,4463,4475,4338,4425,38,120967800,Neutral,0.0
02/09/2022,4425,4500,4363,4488,-63,90044600,Neutral,0.0
05/09/2022,4475,4500,4400,4425,50,60491000,Neutral,0.0
06/09/2022,4413,4500,4400,4488,-75,65296200,Positive,0.1779
07/09/2022,4438,4438,4363,4388,50,97771400,Positive,"0,0237"
08/09/2022,4475,4550,4413,4450,25,96931000,Neutral,0.0
09/09/2022,4538,4550,4475,4538,0,128510800,Neutral,0.0
12/09/2022,4588,4600,4538,4575,13,110819000,Positive,0.5267
13/09/2022,4725,4750,4613,4625,100,185487800,Neutral,0.0
14/09/2022,4650,4700,4600,4638,12,119631200,Neutral,0.0
15/09/2022,4675,4750,4650,4700,-25,156750600,Neutral,0.0
16/09/2022,4550,4650,4513,4638,-88,167812600,Neutral,0.0
19/09/2022,4613,4650,4575,4625,-12,137396600,Neutral,0.0
20/09/2022,4600,4688,4600,4663,-63,140752200,Neutral,0.0
21/09/2022,4638,4638,4550,4575,63,71044400,Neutral,0.0
22/09/2022,4600,4650,4588,4638,-38,96479200,Neutral,0.0
23/09/2022,4600,4625,4575,4600,0,61877000,Positive,"0,7204"
26/09/2022,4625,4688,4475,4563,62,133769600,Neutral,0.0
27/09/2022,4675,4675,4600,4625,50,130959400,Neutral,0.0
28/09/2022,4650,4800,4638,4725,-75,133085000,Neutral,0.0
29/09/2022,4625,4688,4600,4675,-50,67945200,Neutral,0.0
30/09/2022,4713,4713,4613,4650,63,113501000,Neutral,0.0
03/10/2022,4638,4688,4613,4663,-25,54662400,Neutral,0.0
04/10/2022,4613,4688,4613,4650,-37,90247000,Positive,0.8225
05/10/2022,4638,4738,4638,4650,-12,75891600,Neutral,0.0
06/10/2022,4663,4663,4613,4650,13,43279200,Neutral,0.0
07/10/2022,4713,4713,4638,4663,50,51267000,Neutral,0.0
10/10/2022,4650,4700,4638,4688,-38,55465000,Neutral,0.0
11/10/2022,4650,4713,4625,4713,-63,71925600,Negative,"-0,2181"
12/10/2022,4713,4750,4650,4688,25,118731400,Neutral,0.0
13/10/2022,4738,4775,4663,4750,-12,58832000,Neutral,0.0
14/10/2022,4700,4825,4688,4825,-125,106401600,Positive,0.3818
17/10/2022,4725,4738,4650,4725,0,60905200,Neutral,0.0
18/10/2022,4750,4788,4725,4750,0,67904400,Positive,"0,2367"
19/10/2022,4738,4788,4663,4688,50,71544800,Neutral,0.0
20/10/2022,4950,4963,4675,4675,275,102422400,Neutral,0.0
21/10/2022,5175,5225,4963,5000,175,183987800,Neutral,0.0
24/10/2022,5125,5250,5125,5163,-38,102168000,Neutral,0.0
25/10/2022,5113,5225,5113,5138,-25,83305200,Positive,0.1531
26/10/2022,5100,5125,5000,5113,-13,80531400,Positive,0.1779
27/10/2022,5100,5163,5025,5100,0,84531200,Positive,"0,3075"
28/10/2022,5100,5113,5050,5063,37,102437400,Positive,0.5423
31/10/2022,5275,5275,5113,5150,125,173874600,Positive,0.25
01/11/2022,5200,5300,5113,5300,-100,111898000,Neutral,0.0
02/11/2022,5038,5200,4988,5188,-150,127515400,Neutral,0.0
03/11/2022,5088,5100,4975,4975,113,119598600,Neutral,0.0
04/11/2022,5075,5075,5000,5013,62,70781200,Neutral,0.0
07/11/2022,5125,5125,5000,5088,37,98034400,Positive,0.5994
08/11/2022,5075,5138,5038,5138,-63,39585800,Positive,0.4588
09/11/2022,5075,5075,5025,5025,50,68010400,Neutral,0.0
10/11/2022,5050,5075,5000,5025,25,61964000,Neutral,0.0
11/11/2022,5213,5225,5113,5150,63,102008200,Neutral,0.0
14/11/2022,5125,5275,5075,5275,-150,61055200,Neutral,0.0
15/11/2022,5125,5150,5050,5150,-25,83000800,Neutral,0.0
16/11/2022,5000,5088,4950,5050,-50,128257800,Neutral,0.0
17/11/2022,4950,5013,4925,4925,25,167562600,Neutral,0.0
18/11/2022,5088,5113,4963,4975,113,111646200,Neutral,0.0
21/11/2022,5050,5100,5013,5088,-38,52311600,Positive,0.25
22/11/2022,5063,5125,5025,5025,38,79850600,Positive,"0,6287"
23/11/2022,5100,5150,5063,5063,37,78250600,Positive,"0,4715"
24/11/2022,5113,5150,5100,5113,0,59701400,Neutral,0.0
25/11/2022,5088,5113,5050,5113,-25,77984800,Positive,0.4215
28/11/2022,5063,5138,5063,5088,-25,64779000,Positive,0.4404
29/11/2022,5163,5225,5100,5125,38,72261000,Neutral,0.0
30/11/2022,5263,5400,5163,5163,100,347136800,Neutral,0.0
01/12/2022,5200,5325,5200,5263,-63,141493000,Negative,"-0,4924"
02/12/2022,5263,5263,5163,5200,63,70811400,Positive,0.8316
05/12/2022,5438,5500,5288,5325,113,146472800,Neutral,0.0
06/12/2022,5450,5500,5363,5438,12,139360200,Positive,"0,3435"
07/12/2022,5188,5350,5188,5313,-125,200886200,Positive,0.3612
08/12/2022,5025,5113,4988,5038,-13,279908400,Positive,0.4019
09/12/2022,4963,5025,4913,4975,-12,241338200,Neutral,0.0
12/12/2022,4975,5000,4888,4913,62,183717600,Neutral,0.0
13/12/2022,4950,5000,4888,4888,62,224176000,Positive,0.6486
14/12/2022,4975,5050,4975,5038,-63,162689200,Neutral,0.0
15/12/2022,4950,5013,4950,4950,0,82673400,Positive,0.4767
16/12/2022,5050,5050,4913,4913,137,770252400,Positive,0.5106
19/12/2022,5000,5038,4950,5000,0,100871400,Positive,0.128
20/12/2022,5025,5025,4975,5000,25,56633800,Positive,"0,2914"
21/12/2022,5000,5063,5000,5063,-63,37945200,Negative,"-0,3027"
22/12/2022,4975,5050,4975,5050,-75,78836200,Neutral,0.0
23/12/2022,4963,5000,4950,4950,13,38571200,Neutral,0.0
26/12/2022,5025,5025,4975,4988,37,19578800,Neutral,0.0
27/12/2022,4975,5025,4938,5025,-50,43282000,Positive,0.1779
28/12/2022,4988,5000,4925,5000,-12,30258400,Positive,0.1779
29/12/2022,4988,4988,4938,4950,38,56981400,Neutral,0.0
30/12/2022,4963,5025,4963,5000,-37,40655800,Negative,"-0,4088"
02/01/2023,4938,4988,4938,4963,-25,5985400,Neutral,0.0
03/01/2023,4975,4988,4925,4925,50,13815200,Positive,0.1779
04/01/2023,5013,5038,4988,5013,0,38575800,Neutral,0.0
05/01/2023,4913,5025,4863,5025,-112,84945800,Neutral,0.0
06/01/2023,4900,4900,4800,4863,37,44097000,Positive,"0,1142"
09/01/2023,4863,4925,4800,4875,-12,67250600,Neutral,0.0
10/01/2023,4638,4775,4588,4750,-112,214538800,Neutral,0.0
11/01/2023,4475,4588,4450,4538,-63,193915000,Neutral,0.0
12/01/2023,4600,4725,4500,4500,100,219659400,Positive,0.5719
13/01/2023,4588,4613,4525,4563,25,107483800,Neutral,0.0
16/01/2023,4650,4675,4550,4550,100,145710000,Positive,0.34
17/01/2023,4875,4913,4688,4700,175,146238000,Neutral,0.0
18/01/2023,4775,4888,4750,4825,-50,95360600,Neutral,0.0
19/01/2023,4875,4913,4763,4800,75,81704200,Neutral,0.0
20/01/2023,4988,5000,4900,4925,63,93227400,Positive,0.1779
24/01/2023,4950,4988,4900,4925,25,35028000,Neutral,0.0
25/01/2023,4850,4925,4850,4900,-50,72767800,Neutral,0.0
26/01/2023,4913,4938,4875,4888,25,70558600,Neutral,0.0
27/01/2023,5013,5075,4950,4950,63,216788400,Neutral,0.0
30/01/2023,4975,5063,4938,5013,-38,82589400,Neutral,0.0
31/01/2023,4975,5050,4938,5013,-38,167297000,Neutral,0.0
01/02/2023,4850,5025,4838,4975,-125,165628800,Neutral,0.0
02/02/2023,4863,4875,4788,4863,0,99351800,Neutral,0.0
03/02/2023,4963,4975,4875,4875,88,108125400,Neutral,0.0
06/02/2023,4938,5025,4875,4963,-25,109098400,Neutral,0.0
07/02/2023,5088,5113,4950,4975,113,118132000,Neutral,0.0
08/02/2023,5100,5113,5050,5063,37,75656000,Neutral,0.0
09/02/2023,5125,5200,5125,5150,-25,121757400,Neutral,0.0
10/02/2023,5150,5225,5075,5225,-75,81114600,Positive,0.1779
13/02/2023,5175,5275,5125,5275,-100,56771800,Neutral,0.0
14/02/2023,5188,5225,5138,5225,-37,39570600,Negative,"-0,2591"
15/02/2023,5113,5175,5050,5150,-37,75595200,Neutral,0.0
16/02/2023,5088,5138,5063,5113,-25,49569000,Positive,0.6908
17/02/2023,5150,5150,5050,5088,62,58521000,Negative,-0.128
20/02/2023,5138,5150,5100,5150,-12,40696400,Neutral,0.0
21/02/2023,5100,5150,5088,5150,-50,52604400,Neutral,0.0
22/02/2023,5000,5088,4975,5063,-63,75513400,Positive,0.4404
23/02/2023,5038,5050,4963,4988,50,177505200,Positive,0.5106
24/02/2023,5063,5113,5038,5063,0,54138200,Neutral,0.0
27/02/2023,5075,5075,5025,5038,37,47901800,Positive,0.25
28/02/2023,5000,5075,5000,5038,-38,146440400,Positive,0.5106
01/03/2023,5050,5100,5025,5075,-25,89565600,Neutral,0.0
02/03/2023,5113,5150,5075,5075,38,72991800,Neutral,0.0
03/03/2023,5025,5125,5013,5100,-75,88630600,Neutral,0.0
06/03/2023,5063,5113,5038,5088,-25,53728800,Negative,"-0,133"
07/03/2023,5088,5138,5063,5075,13,80065800,Positive,0.5994
08/03/2023,5138,5138,5088,5125,13,104838200,Neutral,0.0
09/03/2023,5225,5250,5175,5200,25,83286000,Positive,0.34
10/03/2023,5188,5213,5138,5213,-25,107531000,Negative,-0.4588
13/03/2023,5175,5188,5113,5138,37,92827600,Positive,"0,3516"
14/03/2023,4963,5138,4925,5100,-137,191898400,Neutral,0.0
15/03/2023,5025,5088,4925,5025,0,262828600,Neutral,0.0
16/03/2023,4925,5038,4913,5038,-113,135467400,Neutral,0.0
17/03/2023,5050,5063,4963,4975,75,224171600,Neutral,0.0
20/03/2023,5000,5050,5000,5025,-25,46333000,Neutral,0.0
21/03/2023,5250,5250,5038,5050,200,131331000,Positive,0.1779
24/03/2023,5450,5475,5288,5313,137,222156200,Positive,"0,2867"
27/03/2023,5100,5213,5100,5200,-100,151825600,Neutral,0.0
28/03/2023,5063,5138,5050,5100,-37,103951000,Positive,0.1531
29/03/2023,5175,5188,5100,5125,50,107454600,Neutral,0.0
30/03/2023,5113,5200,5113,5175,-62,97186200,Neutral,0.0
31/03/2023,5163,5163,5100,5138,25,92013200,Neutral,0.0
03/04/2023,5263,5263,5200,5200,63,101724400,Positive,"0,9812"
04/04/2023,5200,5300,5100,5250,-50,94482600,Neutral,0.0
05/04/2023,5225,5250,5150,5150,75,42655500,Neutral,0.0
06/04/2023,5175,5225,5150,5225,-50,47999400,Negative,"-0,331"
10/04/2023,5100,5175,5050,5150,-50,74787800,Negative,"-0,1195"
11/04/2023,5100,5100,5050,5100,0,37744800,Positive,"0,9511"
12/04/2023,5150,5225,5100,5100,50,111901500,Positive,"0,1366"
13/04/2023,5125,5200,5125,5175,-50,67928500,Negative,"-0,2115"
14/04/2023,5225,5250,5150,5150,75,142479800,Positive,"0,5706"
17/04/2023,5125,5250,5125,5225,-100,95789900,Negative,-0.1779
18/04/2023,5175,5250,5125,5150,25,106962300,Neutral,0.0
26/04/2023,5200,5425,5175,5400,-200,207338000,Positive,0.2263
27/04/2023,5200,5225,5175,5175,25,51076300,Positive,0.9081
28/04/2023,5175,5225,5150,5225,-50,116957800,Neutral,0.0
02/05/2023,5250,5250,5175,5250,0,98024100,Neutral,0.0
03/05/2023,5225,5250,5150,5250,-25,110683000,Negative,"-0,104"
04/05/2023,5175,5225,5125,5175,0,100945900,Neutral,0.0
05/05/2023,5175,5200,5125,5175,0,64499500,Neutral,0.0
08/05/2023,5125,5200,5125,5175,-50,64678000,Negative,"-0,2657"
09/05/2023,5050,5125,5050,5100,-50,93531000,Negative,"-0,2574"
10/05/2023,5075,5125,5050,5050,25,58148200,Neutral,0.0
11/05/2023,5100,5100,5025,5075,25,63262300,Neutral,0.0
12/05/2023,5000,5075,5000,5075,-75,105407300,Neutral,0.0
15/05/2023,5050,5050,5000,5050,0,76451700,Neutral,0.0
16/05/2023,4990,5075,4980,5075,-85,42752200,Neutral,0.0
17/05/2023,5000,5075,4980,4990,10,63396700,Neutral,0.0
19/05/2023,5075,5100,5025,5075,0,78499800,Negative,-0.1779
22/05/2023,5225,5250,5075,5100,125,120027200,Neutral,0.0
23/05/2023,5125,5250,5100,5200,-75,165534100,Neutral,0.0
24/05/2023,5075,5150,5050,5125,-50,125575300,Neutral,0.0
25/05/2023,5175,5175,5050,5050,125,76424100,Positive,"0,7315"
26/05/2023,5125,5200,5100,5175,-50,42313700,Negative,"-0,3665"
29/05/2023,5150,5175,5100,5175,-25,60646900,Negative,"-0,1365"
30/05/2023,5150,5200,5100,5100,50,49086100,Negative,-0.2263
31/05/2023,5050,5200,5050,5175,-125,393735900,Neutral,0.0
05/06/2023,5075,5150,5075,5100,-25,149191300,Negative,"-0,4059"
06/06/2023,5050,5100,4950,5050,0,244590500,Positive,"0,5607"
07/06/2023,5025,5075,5000,5000,25,130408700,Positive,"0,0085"
08/06/2023,5025,5075,5000,5000,25,173484200,Positive,"0,327"
09/06/2023,5125,5125,5000,5025,100,150849200,Neutral,0.0
12/06/2023,5100,5125,5050,5100,0,91080300,Neutral,0.0
13/06/2023,5100,5175,5050,5100,0,143804700,Neutral,0.0
14/06/2023,5050,5150,5050,5125,-75,96670300,Negative,"-0,2907"
15/06/2023,5125,5150,5050,5050,75,94097900,Positive,"0,8611"
16/06/2023,5150,5150,5075,5125,25,103942500,Positive,"0,0264"
19/06/2023,5125,5150,5100,5100,25,36211300,Positive,0.4019
20/06/2023,5100,5125,5050,5100,0,44316800,Neutral,0.0
21/06/2023,5100,5100,5050,5050,50,58061600,Neutral,0.0
22/06/2023,5075,5150,5075,5100,-25,60457300,Neutral,0.0
23/06/2023,5075,5125,5050,5075,0,47276900,Neutral,0.0
26/06/2023,5125,5175,5075,5100,25,74263700,Neutral,0.0
27/06/2023,5200,5250,5150,5175,25,101592900,Neutral,0.0
03/07/2023,5350,5350,5125,5125,225,227354700,Positive,"0,1921"
04/07/2023,5250,5400,5225,5400,-150,119841200,Negative,"-0,3604"
05/07/2023,5275,5325,5250,5300,-25,78430000,Negative,"-0,3189"
06/07/2023,5300,5350,5250,5300,0,90981000,Positive,"0,1249"
07/07/2023,5150,5300,5150,5275,-125,128515100,Negative,"-0,3064"
10/07/2023,5175,5225,5150,5175,0,82685700,Neutral,0.0
11/07/2023,5275,5300,5175,5200,75,100578900,Neutral,0.0
12/07/2023,5300,5375,5250,5300,0,123947700,Neutral,0.0
13/07/2023,5350,5375,5275,5375,-25,101281200,Negative,"-0,3579"
14/07/2023,5400,5425,5350,5400,0,122343600,Positive,"0,5809"
17/07/2023,5375,5475,5375,5425,-50,99897600,Neutral,0.0
18/07/2023,5350,5425,5300,5375,-25,65073800,Neutral,0.0
20/07/2023,5525,5550,5400,5400,125,132054000,Neutral,0.0
21/07/2023,5550,5575,5450,5550,0,111275700,Neutral,0.0
24/07/2023,5500,5625,5500,5550,-50,54865000,Neutral,0.0
25/07/2023,5550,5575,5500,5550,0,65237300,Positive,0.296
26/07/2023,5575,5600,5525,5550,25,88526700,Positive,"0,956"
27/07/2023,5625,5700,5575,5575,50,86556200,Positive,0.1779
28/07/2023,5700,5725,5625,5625,75,121968500,Neutral,0.0
31/07/2023,5725,5800,5625,5800,-75,189375700,Positive,0.5574
01/08/2023,5650,5725,5600,5650,0,114702500,Positive,"0,5978"
02/08/2023,5700,5750,5600,5625,75,133546200,Positive,0.5423
03/08/2023,5800,5825,5700,5725,75,68587500,Neutral,0.0
04/08/2023,5775,5825,5750,5800,-25,47144200,Negative,-0.34
07/08/2023,5875,5925,5825,5850,25,104342100,Neutral,0.0
08/08/2023,5900,5950,5875,5900,0,66473200,Negative,-0.1779
09/08/2023,5900,5950,5850,5900,0,64495400,Neutral,0.0
10/08/2023,5975,6000,5900,5925,50,78859600,Positive,0.5719
11/08/2023,5925,6025,5900,5975,-50,46568600,Neutral,0.0
14/08/2023,5950,5950,5800,5925,25,86460500,Negative,-0.6249
15/08/2023,5800,5925,5800,5900,-100,116815700,Negative,"-0,4757"
16/08/2023,5800,5800,5675,5775,25,163744100,Positive,"0,8858"
18/08/2023,5775,5825,5725,5725,50,104894600,Positive,"0,3571"
21/08/2023,5825,5875,5800,5800,25,61845800,Neutral,0.0
22/08/2023,5950,5950,5800,5800,150,93617200,Positive,0.5994
23/08/2023,5850,5950,5850,5950,-100,40844700,Negative,"-0,1507"
24/08/2023,5950,5950,5875,5900,50,42648300,Positive,"0,0515"
25/08/2023,5900,5925,5825,5900,0,65093100,Positive,"0,0615"
28/08/2023,6000,6025,5900,5950,50,63980400,Positive,"0,2628"
29/08/2023,5950,6025,5950,6000,-50,50839300,Negative,"-0,2613"
30/08/2023,5975,6100,5925,5925,50,65727400,Neutral,0.0
31/08/2023,6025,6075,5900,6000,25,159062900,Neutral,0.0
01/09/2023,6075,6125,6050,6075,0,50796000,Neutral,0.0
04/09/2023,6100,6150,6050,6075,25,56317700,Neutral,0.0
05/09/2023,6100,6150,6075,6100,0,24893100,Neutral,0.0
06/09/2023,6050,6125,6050,6050,0,40547800,Negative,-0.2023
07/09/2023,5875,6025,5825,6000,-125,124351400,Neutral,0.0
08/09/2023,5900,5925,5775,5900,0,81980400,Positive,0.4767
11/09/2023,5925,5925,5825,5900,25,74510600,Positive,"0,1129"
12/09/2023,5875,5950,5850,5950,-75,54076800,Negative,"-0,1902"
13/09/2023,5850,5850,5775,5825,25,69884000,Positive,"0,4203"
14/09/2023,5825,5875,5775,5825,0,59132600,Positive,"0,927"
15/09/2023,5925,5975,5850,5900,25,165106200,Positive,0.4019
18/09/2023,5900,5950,5875,5900,0,53450400,Neutral,0.0
19/09/2023,6000,6075,5875,5900,100,84608400,Neutral,0.0
20/09/2023,6075,6125,6050,6100,-25,64864900,Neutral,0.0
21/09/2023,6000,6075,5975,6050,-50,60535000,Negative,"-0,1677"
22/09/2023,6000,6050,5975,6000,0,51069900,Positive,"0,2981"
25/09/2023,6000,6050,5975,6000,0,40650900,Positive,"0,3187"
26/09/2023,5925,6000,5850,5975,-50,109786400,Negative,"-0,2964"
27/09/2023,6000,6050,5900,5925,75,75050600,Positive,"0,4039"
29/09/2023,6025,6050,6000,6050,-25,71554100,Negative,"-0,4248"
02/10/2023,6050,6100,6025,6025,25,33296500,Neutral,0.0
03/10/2023,6075,6075,6000,6000,75,37093100,Neutral,0.0
04/10/2023,6125,6125,5975,6075,50,69154000,Positive,"0,9664"
05/10/2023,6125,6200,6100,6150,-25,69566800,Neutral,0.0
06/10/2023,6025,6150,6025,6150,-125,25913600,Neutral,0.0
09/10/2023,5900,6050,5900,6025,-125,45321700,Neutral,0.0
10/10/2023,6000,6075,5900,5900,100,42820800,Neutral,0.0
11/10/2023,6050,6175,5950,5950,100,72955000,Neutral,0.0
12/10/2023,6075,6175,6050,6075,0,91341800,Positive,"0,9345"
13/10/2023,6075,6150,6025,6075,0,39914700,Positive,"0,8269"
16/10/2023,6025,6075,5975,6025,0,53416400,Positive,"0,645"
17/10/2023,6000,6025,5925,6000,0,74702300,Neutral,0.0
18/10/2023,5850,5950,5825,5925,-75,80637400,Neutral,0.0
19/10/2023,5725,5800,5700,5775,-50,160277800,Negative,-0.1779
20/10/2023,5750,5800,5650,5675,75,82132000,Positive,"0,0071"
23/10/2023,5675,5725,5625,5700,-25,73897500,Negative,"-0,2072"
24/10/2023,5750,5800,5675,5700,50,72469200,Positive,"0,5515"
25/10/2023,5850,5900,5775,5825,25,90426500,Neutral,0.0
26/10/2023,5700,5850,5700,5800,-100,86348700,Neutral,0.0
27/10/2023,5700,5775,5700,5750,-50,90177000,Positive,0.4019
30/10/2023,5725,5725,5625,5700,25,81547000,Positive,"0,336"
31/10/2023,5675,5850,5650,5800,-125,99449400,Negative,"-0,2694"
01/11/2023,5650,5700,5625,5700,-50,74281200,Neutral,0.0
02/11/2023,5900,5925,5725,5750,150,115678200,Neutral,0.0
03/11/2023,5825,5975,5825,5925,-100,53379500,Neutral,0.0
06/11/2023,5925,5925,5850,5900,25,58266100,Neutral,0.0
07/11/2023,5875,5975,5800,5950,-75,56161300,Positive,0.5267
08/11/2023,5850,5850,5725,5775,75,63442400,Positive,"0,3906"
09/11/2023,5875,5900,5800,5825,50,45026200,Positive,"0,9828"
10/11/2023,5775,5850,5775,5850,-75,59611500,Negative,"-0,2967"
13/11/2023,5825,5850,5800,5850,-25,17444600,Neutral,0.0
14/11/2023,5825,5900,5800,5825,0,50587800,Neutral,0.0
15/11/2023,5925,5975,5875,5900,25,74255700,Positive,"0,8953"
16/11/2023,5925,5925,5825,5850,75,36004500,Positive,0.25
17/11/2023,5900,5950,5850,5875,25,33963900,Neutral,0.0
20/11/2023,5875,5925,5825,5825,50,20014600,Neutral,0.0
21/11/2023,5875,5925,5825,5850,25,55094300,Neutral,0.0
22/11/2023,5875,5900,5825,5825,50,21111100,Neutral,0.0
23/11/2023,5900,5950,5900,5950,-50,36725600,Negative,-0.1779
24/11/2023,5875,5925,5850,5925,-50,27087900,Negative,"-0,4351"
27/11/2023,5900,5925,5875,5900,0,39719300,Positive,"0,697"
28/11/2023,5900,5925,5875,5900,0,58255800,Positive,0.5267
29/11/2023,5850,5925,5825,5850,0,36796600,Neutral,0.0
30/11/2023,5850,5925,5825,5850,0,117365000,Positive,0.2263
01/12/2023,5900,5900,5825,5850,50,31365100,Positive,0.2732
04/12/2023,6000,6025,5900,5925,75,66145100,Positive,"0,1601"
05/12/2023,5975,6000,5875,6000,-25,58668400,Negative,"-0,3597"
06/12/2023,5800,5950,5800,5925,-125,88747200,Neutral,0.0
07/12/2023,5750,5825,5725,5800,-50,97966700,Neutral,0.0
08/12/2023,5700,5775,5650,5750,-50,98036700,Positive,0.5574
11/12/2023,5775,5800,5650,5650,125,68655000,Positive,"0,349"
12/12/2023,5800,5825,5750,5800,0,55110500,Positive,"0,0561"
13/12/2023,5725,5775,5700,5750,-25,121450600,Negative,"-0,4285"
14/12/2023,5950,6025,5800,5825,125,171595800,Neutral,0.0
15/12/2023,5900,6000,5900,5950,-50,142382200,Positive,0.25
18/12/2023,5925,5950,5850,5850,75,101458600,Neutral,0.0
19/12/2023,5975,5975,5925,5950,25,40763200,Positive,0.2263
20/12/2023,5925,5975,5900,5900,25,65361000,Positive,"0,2932"
21/12/2023,5975,5975,5925,5950,25,50363900,Neutral,0.0
22/12/2023,5975,5975,5925,5950,25,29975600,Neutral,0.0
27/12/2023,6000,6025,5925,6000,0,43114900,Neutral,0.0
28/12/2023,6125,6150,6000,6050,75,75118700,Neutral,0.0
29/12/2023,6050,6125,6000,6125,-75,63097100,Neutral,0.0
02/01/2024,6125,6125,6025,6050,75,26235700,Positive,"0,7257"
03/01/2024,6100,6150,6050,6100,0,30053900,Positive,"0,1555"
04/01/2024,6350,6400,6100,6125,225,135344500,Positive,0.4588
05/01/2024,6425,6475,6350,6400,25,114339400,Neutral,0.0
08/01/2024,6400,6600,6375,6500,-100,151018300,Neutral,0.0
09/01/2024,6375,6450,6350,6425,-50,77953400,Negative,"-0,2274"
10/01/2024,6425,6450,6325,6375,50,50019800,Positive,"0,5169"
11/01/2024,6450,6500,6400,6425,25,32120200,Positive,"0,1"
12/01/2024,6575,6675,6525,6575,0,114039700,Neutral,0.0
15/01/2024,6500,6625,6475,6575,-75,83066800,Negative,"-0,2205"
16/01/2024,6525,6625,6500,6525,0,83516800,Neutral,0.0
17/01/2024,6525,6625,6500,6525,0,80929000,Positive,0.25
18/01/2024,6525,6550,6475,6525,0,78209900,Neutral,0.0
19/01/2024,6525,6525,6425,6500,25,74814000,Neutral,0.0
22/01/2024,6500,6550,6450,6500,0,96993100,Positive,"0,005"
23/01/2024,6500,6550,6450,6525,-25,77037800,Negative,"-0,2235"
24/01/2024,6400,6475,6350,6450,-50,97290600,Negative,"-0,3755"
25/01/2024,6275,6400,6250,6325,-50,99094100,Neutral,0.0
26/01/2024,6300,6325,6225,6250,50,77236800,Neutral,0.0
29/01/2024,6475,6475,6275,6350,125,124753000,Positive,0.0516
30/01/2024,6650,6700,6450,6475,175,123330900,Positive,"0,3645"
31/01/2024,6650,6700,6650,6650,0,128185000,Positive,"0,6568"
01/02/2024,6550,6625,6500,6575,-25,168145800,Negative,"-0,4384"
02/02/2024,6675,6675,6600,6625,50,120116200,Positive,"0,9636"
05/02/2024,6825,6950,6675,6700,125,150535100,Positive,"0,8565"
06/02/2024,6850,6925,6775,6825,25,90146000,Positive,"0,8724"
07/02/2024,6950,6950,6850,6875,75,88745500,Positive,"0,0624"
12/02/2024,7100,7200,7050,7150,-50,162771300,Negative,"-0,3699"
13/02/2024,7025,7125,7025,7100,-75,102668900,Negative,"-0,1951"
15/02/2024,7200,7375,7150,7300,-100,220530000,Negative,"-0,2107"
16/02/2024,7200,7400,7200,7375,-175,142022100,Negative,"-0,2091"
19/02/2024,7150,7325,7125,7150,0,83753500,Positive,"0,3145"
20/02/2024,7150,7250,7150,7250,-100,87312000,Negative,"-0,4067"
21/02/2024,7250,7250,7075,7125,125,128063900,Positive,"0,652"
22/02/2024,7100,7200,7100,7175,-75,85735800,Negative,"-0,1742"
23/02/2024,7050,7100,7000,7050,0,109404700,Positive,"0,68"
26/02/2024,7050,7075,6950,6950,100,65407700,Neutral,0.0
27/02/2024,7075,7100,6975,6975,100,58066100,Neutral,0.0
28/02/2024,7125,7125,7025,7025,100,49888400,Positive,"0,1131"
29/02/2024,7000,7150,7000,7125,-125,150713600,Negative,"-0,2939"
01/03/2024,7025,7075,6975,7050,-25,90739400,Negative,"-0,4792"
04/03/2024,7025,7050,6975,7000,25,44707200,Positive,0.4939
05/03/2024,7025,7100,7000,7075,-50,92557200,Neutral,0.0
06/03/2024,7075,7100,7000,7000,75,74178100,Neutral,0.0
07/03/2024,7100,7125,7025,7075,25,94950400,Neutral,0.0
08/03/2024,7125,7175,7100,7150,-25,109032400,Neutral,0.0
13/03/2024,7275,7275,7150,7250,25,126022700,Neutral,0.0
14/03/2024,7400,7400,7225,7250,150,161193000,Positive,"0,1605"
15/03/2024,7400,7500,7275,7450,-50,250581100,Neutral,0.0
18/03/2024,7175,7425,7175,7425,-250,105778200,Positive,0.1779
19/03/2024,7275,7350,7225,7250,25,100836600,Positive,0.4019
20/03/2024,7050,7050,7000,7050,0,83416700,Neutral,0.0
21/03/2024,7050,7200,7050,7100,-50,81774800,Positive,0.4019
22/03/2024,7050,7075,6950,7000,50,65219900,Positive,"0,3409"
25/03/2024,7250,7250,7000,7250,0,78212700,Neutral,0.0
26/03/2024,7175,7225,7125,7225,-50,74274300,Neutral,0.0
27/03/2024,7175,7250,7175,7200,-25,46295700,Neutral,0.0
28/03/2024,7250,7250,7125,7150,100,90900900,Positive,"0,1477"
01/04/2024,6900,7250,6750,7250,-350,158358600,Neutral,0.0
02/04/2024,6900,6900,6700,6900,0,135764900,Neutral,0.0
03/04/2024,6775,6950,6675,6950,-175,115372600,Neutral,0.0
04/04/2024,6875,6925,6750,6750,125,63174900,Neutral,0.0
05/04/2024,6825,6900,6825,6825,0,46111500,Negative,-0.3182
16/04/2024,6625,6725,6300,6350,275,180012400,Neutral,0.0
17/04/2024,6625,6775,6625,6700,-75,83840200,Neutral,0.0
18/04/2024,6800,6900,6725,6800,0,106893900,Positive,0.25
19/04/2024,6725,6800,6650,6725,0,47943300,Positive,0.2023
22/04/2024,6725,6875,6575,6875,-150,121727900,Positive,0.3818
23/04/2024,6825,6925,6725,6850,-25,106699200,Neutral,0.0
24/04/2024,7050,7050,6900,6925,125,117586500,Neutral,0.0
25/04/2024,6950,7075,6925,7050,-100,111803500,Negative,"-0,1739"
26/04/2024,6750,7025,6750,7000,-250,125875000,Negative,-0.1779
29/04/2024,6925,6950,6650,6650,275,77938400,Neutral,0.0
30/04/2024,6900,7050,6775,6800,100,189991300,Positive,"0,6175"
02/05/2024,6325,6800,6050,6800,-475,501849300,Negative,"-0,2608"
03/05/2024,6150,6425,6050,6300,-150,269305400,Negative,"-0,2799"
06/05/2024,6275,6400,6150,6250,25,184234200,Positive,"0,2861"
07/05/2024,6275,6400,6250,6325,-50,130410300,Negative,"-0,4922"
08/05/2024,6275,6450,6250,6325,-50,117065300,Negative,"-0,3374"
13/05/2024,6200,6275,6125,6200,0,128638300,Positive,"0,8983"
14/05/2024,6200,6300,6175,6175,25,94048400,Positive,"0,8045"
15/05/2024,6375,6400,6200,6200,175,80923000,Positive,"0,1228"
16/05/2024,6350,6500,6325,6450,-100,114806300,Negative,"-0,1755"
17/05/2024,6575,6650,6350,6350,225,133153900,Positive,"0,7435"
20/05/2024,6325,6625,6200,6550,-225,168796000,Negative,"-0,4436"
21/05/2024,6025,6275,5975,6225,-200,307362900,Negative,"-0,3497"
22/05/2024,6050,6150,5950,6000,50,171675900,Positive,"0,7391"
27/05/2024,5825,6050,5825,6025,-200,258450900,Negative,"-0,3972"
28/05/2024,5950,6025,5825,5850,100,93701700,Positive,"0,7882"
29/05/2024,5800,5875,5700,5825,-25,169386300,Negative,"-0,1359"
30/05/2024,5875,6000,5525,5775,100,236632600,Positive,"0,1789"
31/05/2024,5900,6025,5900,6000,-100,169567000,Negative,"-0,2338"
03/06/2024,6100,6150,6025,6075,25,92525600,Negative,-0.2023
04/06/2024,6150,6275,6125,6150,0,137800600,Positive,0.2023
05/06/2024,6000,6150,5975,6125,-125,102327300,Neutral,0.0
06/06/2024,6175,6200,6075,6125,50,85735200,Positive,"0,9731"
07/06/2024,6275,6275,6150,6250,25,99092800,Positive,"0,5113"
10/06/2024,6275,6350,6200,6275,0,80154400,Positive,"0,6015"
11/06/2024,6125,6250,6125,6200,-75,56254400,Negative,"-0,3225"
12/06/2024,5925,6075,5900,6050,-125,120857200,Negative,"-0,3654"
13/06/2024,5875,6000,5850,5975,-100,162616700,Negative,"-0,2646"
14/06/2024,5750,5875,5650,5850,-100,203241500,Negative,"-0,3166"
19/06/2024,5750,5850,5675,5775,-25,116004200,Neutral,0.0
20/06/2024,5950,5950,5750,5825,125,82660000,Positive,"0,3434"
21/06/2024,6125,6200,6025,6050,75,184240600,Neutral,0.0
24/06/2024,6000,6125,6000,6075,-75,58831900,Neutral,0.0
25/06/2024,5925,5975,5825,5925,0,159983800,Neutral,0.0
26/06/2024,5850,6025,5850,5950,-100,92895700,Neutral,0.0
27/06/2024,6000,6075,5875,5900,100,117602400,Positive,"0,6453"
28/06/2024,6150,6250,6000,6000,150,191371600,Positive,"0,6066"
01/07/2024,6250,6250,6100,6175,75,100408200,Positive,0.3818
02/07/2024,6200,6350,6150,6275,-75,159356600,Neutral,0.0
03/07/2024,6225,6300,6100,6275,-50,70017100,Negative,"-0,2122"
04/07/2024,6250,6400,6225,6250,0,90147800,Positive,0.1779
05/07/2024,6425,6500,6300,6325,100,111646800,Neutral,0.0
08/07/2024,6225,6425,6200,6400,-175,138144000,Negative,-0.1779
09/07/2024,6375,6400,6200,6225,150,84177600,Neutral,0.0
10/07/2024,6375,6450,6300,6375,0,59685300,Neutral,0.0
11/07/2024,6400,6425,6350,6400,0,66789800,Neutral,-0.0
12/07/2024,6425,6550,6400,6450,-25,136132200,Negative,"-0,1354"
15/07/2024,6350,6450,6300,6450,-100,66071800,Negative,"-0,4192"
16/07/2024,6350,6400,6300,6400,-50,64687900,Neutral,0.0
17/07/2024,6450,6525,6375,6450,0,109729800,Neutral,0.0
18/07/2024,6550,6600,6500,6550,0,132532000,Neutral,0.0
19/07/2024,6525,6525,6450,6500,25,63165500,Positive,0.1779
22/07/2024,6700,6700,6525,6575,125,110467000,Positive,"0,4811"
23/07/2024,6625,6750,6550,6750,-125,77861700,Negative,"-0,107"
24/07/2024,6475,6575,6475,6500,-25,63940900,Negative,-0.2023
25/07/2024,6575,6575,6400,6450,125,66655400,Neutral,0.0
26/07/2024,6550,6625,6500,6575,-25,76519500,Neutral,0.0
29/07/2024,6475,6550,6450,6550,-75,54435300,Neutral,0.0
30/07/2024,6475,6550,6375,6475,0,86701400,Neutral,0.0
31/07/2024,6400,6475,6375,6400,0,99004100,Neutral,0.0
01/08/2024,6750,6750,6500,6550,200,163086200,Positive,0.1779
02/08/2024,6800,6875,6675,6700,100,167892400,Positive,"0,8249"
05/08/2024,6575,6725,6500,6700,-125,184384000,Negative,-0.2732
06/08/2024,6625,6700,6525,6650,-25,95785000,Neutral,0.0
07/08/2024,6775,6775,6650,6725,50,84582200,Neutral,-0.0
08/08/2024,6800,6850,6725,6800,0,81408500,Neutral,0.0
09/08/2024,6850,6900,6800,6825,25,79710700,Positive,"0,6581"
12/08/2024,6900,6900,6775,6875,25,50756000,Neutral,0.0
13/08/2024,7000,7000,6850,6850,150,68666000,Neutral,0.0
14/08/2024,7075,7100,7025,7075,0,97695100,Neutral,0.0
15/08/2024,7025,7075,6925,7075,-50,75955500,Negative,-0.1779
16/08/2024,7075,7125,7025,7075,0,64266400,Positive,0.743
19/08/2024,7150,7150,7025,7075,75,50246100,Positive,"0,3563"
20/08/2024,7200,7350,7150,7200,0,102615900,Positive,"0,1059"
21/08/2024,7250,7300,7225,7300,-50,88487800,Negative,"-0,1814"
22/08/2024,7050,7175,6925,7150,-100,157323000,Negative,-0.296
23/08/2024,7050,7075,6975,7000,50,111752100,Neutral,0.0
26/08/2024,7050,7100,7000,7050,0,78515400,Positive,"0,314"
27/08/2024,7025,7050,6925,7025,0,91686700,Positive,"0,5836"
28/08/2024,7225,7225,7000,7025,200,114606200,Neutral,0.0
29/08/2024,7100,7300,7100,7300,-200,94475900,Neutral,0.0