Date,close,high,low,open,margin,Volume,sentiment,compound_score
02/01/2014,2025,2025,1963,1975,50,63.984.000,Positive,"0,5986"
03/01/2014,1950,2025,1938,2013,-63,105.794.000,Negative,"-0,1843"
06/01/2014,1913,1963,1900,1950,-37,51.674.800,Negative,"-0,1695"
07/01/2014,1906,1931,1900,1913,-7,81.169.200,Negative,"-0,2542"
08/01/2014,1956,1963,1913,1925,31,59.954.000,Positive,"0,5808"
09/01/2014,1950,1981,1925,1956,-6,71.207.200,Negative,"-0,289"
10/01/2014,2063,2094,1950,1950,113,153.947.200,Positive,"0,2032"
13/01/2014,2200,2200,2119,2125,75,228.783.600,Positive,"0,5944"
15/01/2014,2200,2381,2181,2206,-6,220.250.000,Negative,"-0,3431"
16/01/2014,2156,2225,2156,2219,-63,76.988.000,Negative,"-0,1967"
17/01/2014,2188,2200,2156,2156,32,58.350.000,Positive,"0,175"
20/01/2014,2188,2200,2169,2200,-12,27.171.600,Negative,"-0,1027"
21/01/2014,2194,2206,2188,2200,-6,59.725.600,Negative,"-0,4746"
22/01/2014,2238,2244,2181,2200,38,110.857.200,Positive,"0,3859"
23/01/2014,2219,2269,2219,2250,-31,109.866.800,Negative,"-0,4545"
24/01/2014,2169,2225,2156,2169,0,109.728.400,Positive,"0,3192"
27/01/2014,2075,2100,2038,2063,12,210.759.200,Positive,"0,6519"
28/01/2014,2069,2088,2038,2063,6,164.112.800,Positive,"0,8106"
29/01/2014,2175,2188,2075,2088,87,190.262.800,Positive,"0,413"
30/01/2014,2175,2175,2094,2113,62,132.577.200,Positive,"0,7833"
03/02/2014,2175,2206,2138,2206,-31,108.214.000,Negative,"-0,3153"
04/02/2014,2131,2156,2100,2131,0,95.244.800,Positive,"0,9254"
05/02/2014,2150,2163,2125,2163,-13,84.726.400,Negative,"-0,3519"
06/02/2014,2156,2163,2125,2163,-7,70.481.600,Negative,"-0,1817"
07/02/2014,2194,2213,2163,2169,25,101.737.200,Positive,"0,9833"
10/02/2014,2188,2231,2188,2213,-25,72.448.800,Negative,"-0,4896"
11/02/2014,2238,2263,2213,2219,19,206.115.200,Positive,"0,569"
12/02/2014,2244,2275,2219,2269,-25,131.831.600,Negative,"-0,4515"
13/02/2014,2250,2250,2231,2250,0,59.296.000,Positive,"0,0101"
14/02/2014,2256,2263,2238,2250,6,107.262.000,Positive,"0,3185"
17/02/2014,2288,2294,2263,2269,19,160.782.000,Positive,"0,8711"
18/02/2014,2281,2294,2263,2288,-7,114.412.800,Negative,"-0,1942"
19/02/2014,2281,2300,2263,2281,0,168.598.000,Positive,"0,9566"
20/02/2014,2306,2319,2275,2275,31,147.004.400,Positive,"0,555"
21/02/2014,2356,2356,2306,2313,43,195.956.800,Positive,"0,3266"
24/02/2014,2350,2413,2344,2375,-25,147.883.200,Negative,"-0,1908"
25/02/2014,2263,2375,2256,2375,-112,125.208.400,Negative,"-0,308"
26/02/2014,2238,2275,2206,2250,-12,222.663.200,Negative,"-0,1193"
27/02/2014,2250,2269,2231,2238,12,89.265.200,Positive,"0,5387"
28/02/2014,2275,2281,2238,2263,12,130.770.000,Positive,"0,5255"
03/03/2014,2275,2275,2250,2250,25,128.786.400,Positive,"0,1295"
04/03/2014,2281,2300,2256,2275,6,137.225.200,Positive,"0,9537"
05/03/2014,2350,2350,2294,2300,50,189.594.000,Positive,"0,2778"
06/03/2014,2350,2369,2344,2369,-19,95.042.800,Negative,"-0,1975"
07/03/2014,2313,2375,2306,2375,-62,68.054.000,Negative,"-0,1408"
10/03/2014,2300,2344,2275,2344,-44,85.980.000,Negative,"-0,2617"
11/03/2014,2344,2350,2300,2313,31,122.784.000,Positive,"0,427"
12/03/2014,2306,2338,2294,2306,0,78.838.000,Positive,"0,5154"
13/03/2014,2325,2325,2300,2300,25,71.212.800,Positive,"0,2271"
14/03/2014,2538,2563,2288,2300,238,379.488.800,Positive,"0,1822"
17/03/2014,2494,2538,2431,2500,-6,226.867.600,Negative,"-0,2324"
18/03/2014,2431,2500,2431,2475,-44,131.869.200,Negative,"-0,2991"
19/03/2014,2444,2463,2425,2431,13,128.559.200,Positive,"0,2338"
20/03/2014,2338,2438,2331,2438,-100,237.560.400,Negative,"-0,1972"
21/03/2014,2344,2375,2331,2356,-12,151.603.200,Negative,"-0,2328"
24/03/2014,2375,2394,2350,2375,0,108.480.800,Positive,"0,7223"
25/03/2014,2381,2381,2356,2363,18,79.857.600,Positive,"0,6664"
26/03/2014,2394,2419,2375,2394,0,127.667.600,Positive,"0,3669"
27/03/2014,2350,2388,2350,2350,0,105.750.800,Positive,"0,8922"
28/03/2014,2363,2400,2350,2381,-18,376.191.600,Negative,"-0,4113"
01/04/2014,2488,2488,2394,2394,94,268.127.600,Positive,"0,3727"
02/04/2014,2538,2550,2494,2500,38,178.996.000,Positive,"0,4374"
03/04/2014,2575,2575,2525,2550,25,157.111.200,Positive,"0,6336"
04/04/2014,2531,2588,2506,2581,-50,96.803.200,Negative,"-0,2093"
07/04/2014,2563,2569,2513,2531,32,135.627.200,Positive,"0,8698"
08/04/2014,2563,2575,2538,2575,-12,95.152.000,Negative,"-0,2308"
09/04/2014,2563,2563,2563,2563,0,0,Positive,"0,2258"
10/04/2014,2413,2438,2381,2388,25,450.579.200,Positive,"0,3795"
11/04/2014,2425,2450,2388,2400,25,184.430.400,Positive,"0,9415"
14/04/2014,2438,2444,2419,2419,19,142.453.200,Positive,"0,7691"
15/04/2014,2438,2456,2438,2450,-12,76.331.600,Negative,"-0,1221"
16/04/2014,2494,2506,2450,2456,38,106.918.800,Positive,"0,402"
17/04/2014,2463,2525,2444,2519,-56,147.078.800,Negative,"-0,4773"
21/04/2014,2456,2469,2450,2469,-13,38.727.200,Negative,"-0,1463"
22/04/2014,2463,2481,2431,2469,-6,115.042.000,Negative,"-0,2684"
23/04/2014,2475,2488,2456,2463,12,80.303.200,Positive,"0,4422"
24/04/2014,2469,2475,2450,2456,13,69.398.000,Positive,"0,8023"
25/04/2014,2475,2500,2463,2469,6,71.704.000,Positive,"0,2516"
28/04/2014,2438,2500,2431,2500,-62,116.084.400,Negative,"-0,4193"
29/04/2014,2450,2475,2431,2475,-25,46.608.800,Negative,"-0,2755"
30/04/2014,2456,2463,2444,2450,6,93.242.400,Positive,"0,4558"
02/05/2014,2469,2494,2463,2475,-6,86.257.200,Negative,"-0,2841"
05/05/2014,2463,2488,2444,2469,-6,56.014.400,Negative,"-0,4025"
06/05/2014,2469,2475,2456,2475,-6,21.791.600,Negative,"-0,3771"
07/05/2014,2494,2500,2463,2463,31,82.346.400,Positive,"0,2813"
08/05/2014,2506,2513,2488,2506,0,43.227.200,Positive,"0,5617"
09/05/2014,2519,2525,2488,2525,-6,48.956.000,Negative,"-0,2717"
12/05/2014,2494,2525,2494,2525,-31,70.641.200,Negative,"-0,4666"
13/05/2014,2519,2519,2500,2519,0,61.065.600,Positive,"0,1302"
14/05/2014,2581,2588,2519,2525,56,219.808.400,Positive,"0,7234"
16/05/2014,2650,2650,2569,2575,75,202.264.800,Positive,"0,9071"
19/05/2014,2656,2706,2606,2656,0,225.986.800,Positive,"0,0733"
20/05/2014,2525,2663,2500,2525,0,210.495.200,Positive,"0,449"
21/05/2014,2538,2550,2506,2538,0,69.045.200,Positive,"0,1595"
22/05/2014,2594,2606,2550,2594,0,106.400.400,Positive,"0,5999"
23/05/2014,2594,2606,2575,2594,0,51.238.400,Positive,"0,3061"
26/05/2014,2581,2613,2556,2581,0,35.746.000,Positive,"0,8539"
28/05/2014,2594,2600,2569,2594,0,79.694.000,Positive,"0,8537"
30/05/2014,2544,2594,2513,2544,0,247.178.400,Positive,"0,4308"
02/06/2014,2550,2563,2531,2550,0,76.876.800,Positive,"0,064"
03/06/2014,2550,2556,2519,2550,0,126.123.600,Positive,"0,0178"
04/06/2014,2538,2556,2525,2538,0,106.749.600,Positive,"0,1628"
05/06/2014,2550,2550,2506,2550,0,66.263.600,Positive,"0,897"
06/06/2014,2519,2544,2506,2519,0,107.951.200,Positive,"0,7189"
09/06/2014,2450,2544,2438,2450,0,134.515.200,Positive,"0,7349"
10/06/2014,2494,2494,2456,2494,0,148.333.200,Positive,"0,074"
11/06/2014,2488,2494,2463,2488,0,98.108.000,Positive,"0,1472"
12/06/2014,2481,2494,2463,2481,0,104.930.800,Positive,"0,2619"
13/06/2014,2481,2488,2463,2481,0,82.041.200,Positive,"0,6747"
16/06/2014,2463,2481,2438,2463,0,61.751.200,Positive,"0,2129"
17/06/2014,2475,2481,2444,2475,0,60.293.600,Positive,"0,5485"
18/06/2014,2469,2481,2463,2469,0,87.876.000,Positive,"0,2423"
19/06/2014,2450,2481,2444,2450,0,105.030.000,Positive,"0,5232"
20/06/2014,2450,2469,2444,2450,0,67.474.800,Positive,"0,0872"
23/06/2014,2438,2469,2431,2438,0,92.584.000,Positive,"0,6804"
24/06/2014,2444,2456,2431,2444,0,62.032.400,Positive,"0,5667"
25/06/2014,2438,2456,2425,2438,0,103.590.400,Positive,"0,9132"
26/06/2014,2463,2475,2438,2463,0,149.123.600,Positive,"0,3047"
27/06/2014,2413,2463,2406,2413,0,133.020.400,Positive,"0,4047"
30/06/2014,2431,2431,2406,2431,0,80.812.800,Positive,"0,6287"
01/07/2014,2456,2463,2425,2456,0,67.317.200,Positive,"0,797"
02/07/2014,2463,2469,2444,2463,0,107.994.400,Positive,"0,5358"
03/07/2014,2413,2469,2406,2413,0,177.824.000,Positive,"0,5435"
04/07/2014,2419,2438,2413,2419,0,70.222.800,Positive,"0,5343"
07/07/2014,2481,2481,2431,2481,0,255.845.600,Positive,"0,683"
08/07/2014,2538,2556,2494,2538,0,408.720.400,Positive,"0,8025"
09/07/2014,2538,2538,2538,2538,0,0,Positive,"0,6146"
10/07/2014,2619,2750,2594,2619,0,801.523.200,Positive,"0,7687"
11/07/2014,2625,2625,2569,2625,0,186.758.800,Positive,"0,4669"
14/07/2014,2625,2631,2588,2625,0,118.788.000,Positive,"0,2731"
15/07/2014,2638,2644,2619,2638,0,137.040.000,Positive,"0,0164"
16/07/2014,2650,2675,2638,2650,0,109.010.800,Positive,"0,5102"
17/07/2014,2656,2669,2631,2656,0,107.004.800,Positive,"0,4232"
18/07/2014,2656,2675,2625,2656,0,95.748.000,Positive,"0,1161"
21/07/2014,2663,2688,2650,2663,0,127.907.200,Positive,"0,036"
22/07/2014,2619,2681,2600,2619,0,232.130.800,Positive,"0,9395"
23/07/2014,2625,2663,2613,2625,0,56.408.400,Positive,"0,2918"
24/07/2014,2613,2631,2594,2613,0,111.699.200,Positive,"0,1239"
25/07/2014,2563,2588,2538,2563,0,155.539.600,Positive,"0,0588"
04/08/2014,2569,2569,2506,2569,0,154.489.200,Positive,"0,3137"
05/08/2014,2600,2600,2544,2600,0,73.754.000,Positive,"0,2946"
06/08/2014,2569,2588,2556,2569,0,88.148.800,Positive,"0,7578"
07/08/2014,2550,2563,2513,2550,0,94.302.400,Positive,"0,4019"
08/08/2014,2550,2556,2538,2550,0,59.980.800,Positive,"0,2797"
11/08/2014,2619,2625,2569,2619,0,67.873.600,Positive,"0,3451"
12/08/2014,2625,2638,2606,2625,0,129.655.600,Positive,"0,9815"
13/08/2014,2625,2625,2588,2625,0,52.008.000,Positive,"0,2617"
14/08/2014,2619,2631,2613,2619,0,73.004.400,Positive,"0,8871"
15/08/2014,2613,2625,2606,2613,0,23.361.600,Positive,"0,6789"
18/08/2014,2619,2631,2606,2619,0,98.694.400,Positive,"0,755"
19/08/2014,2631,2638,2619,2631,0,94.816.400,Positive,"0,3708"
20/08/2014,2638,2644,2631,2638,0,82.936.400,Positive,"0,0261"
21/08/2014,2638,2656,2625,2638,0,105.621.600,Positive,"0,6248"
22/08/2014,2631,2663,2619,2631,0,85.906.400,Positive,"0,3406"
25/08/2014,2644,2650,2613,2644,0,54.252.400,Positive,"0,0914"
26/08/2014,2619,2650,2613,2619,0,54.252.000,Positive,"0,5663"
27/08/2014,2638,2644,2625,2638,0,62.226.400,Positive,"0,2597"
28/08/2014,2631,2644,2613,2631,0,35.008.400,Positive,"0,6387"
29/08/2014,2594,2638,2594,2594,0,73.210.800,Positive,"0,8399"
01/09/2014,2625,2625,2594,2625,0,24.629.200,Positive,"0,297"
02/09/2014,2625,2638,2625,2625,0,54.608.000,Positive,"0,2483"
03/09/2014,2638,2644,2625,2638,0,66.228.000,Positive,"0,6112"
04/09/2014,2638,2650,2625,2638,0,56.440.800,Positive,"0,9298"
05/09/2014,2619,2650,2613,2619,0,44.564.800,Positive,"0,8858"
08/09/2014,2638,2663,2613,2638,0,57.887.200,Positive,"0,2533"
09/09/2014,2619,2638,2613,2619,0,28.824.000,Positive,"0,4832"
10/09/2014,2613,2625,2594,2613,0,82.266.000,Positive,"0,1516"
11/09/2014,2600,2625,2594,2600,0,113.945.600,Positive,"0,458"
12/09/2014,2550,2594,2550,2550,0,129.725.600,Positive,"0,9223"
15/09/2014,2556,2563,2513,2556,0,88.174.800,Positive,"0,8132"
16/09/2014,2538,2556,2531,2538,0,75.382.800,Positive,"0,6653"
17/09/2014,2569,2588,2544,2569,0,53.077.600,Positive,"0,0767"
18/09/2014,2606,2613,2575,2606,0,49.814.000,Positive,"0,6042"
19/09/2014,2631,2650,2606,2631,0,105.775.600,Positive,"0,7175"
22/09/2014,2663,2663,2619,2663,0,107.543.200,Positive,"0,0697"
23/09/2014,2675,2675,2644,2675,0,95.076.400,Positive,"0,3549"
24/09/2014,2638,2663,2638,2638,0,44.105.200,Positive,"0,6312"
25/09/2014,2631,2663,2581,2631,0,158.243.200,Positive,"0,4985"
26/09/2014,2513,2550,2506,2513,0,250.778.800,Positive,"0,8379"
29/09/2014,2519,2525,2456,2519,0,155.296.800,Positive,"0,6679"
30/09/2014,2519,2544,2500,2519,0,122.798.400,Positive,"0,213"
01/10/2014,2525,2594,2519,2525,0,89.411.200,Positive,"0,6822"
02/10/2014,2475,2544,2475,2475,0,143.686.400,Positive,"0,6565"
03/10/2014,2413,2494,2388,2413,0,165.436.800,Positive,"0,949"
06/10/2014,2456,2463,2413,2456,0,97.244.800,Positive,"0,7331"
07/10/2014,2438,2475,2431,2438,0,108.166.000,Positive,"0,9983"
08/10/2014,2375,2425,2363,2375,0,248.045.200,Positive,"0,5926"
09/10/2014,2388,2419,2388,2388,0,75.312.400,Positive,"0,8519"
10/10/2014,2388,2388,2338,2388,0,101.417.600,Positive,"0,5119"
13/10/2014,2350,2369,2331,2350,0,127.360.400,Positive,"0,1539"
14/10/2014,2363,2381,2325,2363,0,96.061.600,Positive,"0,4282"
15/10/2014,2413,2425,2375,2413,0,89.523.600,Positive,"0,1399"
16/10/2014,2413,2425,2375,2413,0,78.677.600,Positive,"0,9066"
17/10/2014,2481,2525,2413,2481,0,197.240.400,Positive,"0,3428"
20/10/2014,2531,2550,2494,2531,0,152.256.400,Positive,"0,9443"
21/10/2014,2506,2538,2488,2506,0,66.651.200,Positive,"0,5237"
22/10/2014,2525,2531,2500,2525,0,66.994.800,Positive,"0,9553"
23/10/2014,2544,2550,2513,2544,0,72.442.400,Positive,"0,3106"
24/10/2014,2525,2556,2506,2525,0,81.342.400,Positive,"0,4188"
27/10/2014,2494,2544,2488,2494,0,67.994.000,Positive,"0,8112"
28/10/2014,2500,2513,2481,2500,0,46.372.400,Positive,"0,6394"
29/10/2014,2544,2544,2506,2544,0,87.597.600,Positive,"0,4526"
30/10/2014,2550,2550,2519,2550,0,54.349.200,Positive,"0,1093"
31/10/2014,2588,2588,2550,2588,0,71.242.800,Positive,"0,1542"
03/11/2014,2594,2606,2563,2594,0,44.479.600,Positive,"0,2411"
04/11/2014,2625,2631,2588,2625,0,95.046.800,Positive,"0,8597"
05/11/2014,2606,2625,2575,2606,0,41.149.600,Positive,"0,0298"
06/11/2014,2581,2625,2581,2581,0,83.054.800,Positive,"0,3838"
07/11/2014,2544,2625,2525,2544,0,51.160.800,Positive,"0,199"
10/11/2014,2575,2581,2563,2575,0,58.935.600,Positive,"0,4472"
11/11/2014,2631,2656,2575,2631,0,104.714.400,Positive,"0,9065"
12/11/2014,2638,2681,2631,2638,0,98.669.600,Positive,"0,9076"
13/11/2014,2606,2631,2581,2606,0,63.121.200,Positive,"0,33"
14/11/2014,2625,2638,2594,2625,0,40.744.800,Positive,"0,3025"
17/11/2014,2619,2644,2619,2625,-6,71.210.000,Negative,"-0,1817"
18/11/2014,2625,2663,2613,2625,0,86.135.600,Positive,"0,4128"
19/11/2014,2631,2656,2619,2631,0,84.622.800,Positive,"0,2787"
20/11/2014,2613,2631,2606,2613,0,41.546.000,Positive,"0,1702"
21/11/2014,2594,2625,2588,2594,0,54.756.400,Positive,"0,4825"
24/11/2014,2625,2638,2613,2625,0,66.688.400,Positive,"0,6633"
25/11/2014,2613,2644,2613,2613,0,90.611.600,Positive,"0,5775"
26/11/2014,2631,2638,2619,2631,0,46.545.200,Positive,"0,5563"
27/11/2014,2619,2631,2613,2619,0,40.903.600,Positive,"0,4451"
28/11/2014,2631,2638,2613,2631,0,44.246.000,Positive,"0,0115"
01/12/2014,2656,2663,2631,2638,18,73.759.200,Positive,"0,7588"
02/12/2014,2688,2700,2656,2663,25,139.652.400,Positive,"0,2774"
03/12/2014,2675,2694,2669,2688,-13,50.463.600,Negative,"-0,1545"
04/12/2014,2656,2688,2650,2675,-19,42.235.600,Negative,"-0,1592"
05/12/2014,2663,2694,2663,2681,-18,40.322.400,Negative,"-0,2811"
08/12/2014,2638,2694,2619,2688,-50,69.020.800,Negative,"-0,3367"
09/12/2014,2631,2663,2625,2631,0,43.210.000,Positive,"0,8832"
10/12/2014,2694,2700,2638,2650,44,67.644.800,Positive,"0,1399"
11/12/2014,2681,2700,2644,2644,37,65.913.200,Positive,"0,2753"
12/12/2014,2688,2719,2675,2675,13,75.546.800,Positive,"0,4864"
15/12/2014,2631,2663,2625,2650,-19,90.029.600,Negative,"-0,4633"
16/12/2014,2556,2613,2544,2613,-57,205.105.600,Negative,"-0,3933"
17/12/2014,2650,2663,2531,2550,100,97.264.000,Positive,"0,3205"
18/12/2014,2663,2694,2650,2688,-25,95.119.600,Negative,"-0,2909"
19/12/2014,2663,2688,2656,2688,-25,93.536.800,Negative,"-0,1086"
22/12/2014,2656,2688,2656,2675,-19,32.630.400,Negative,"-0,4835"
23/12/2014,2650,2681,2650,2675,-25,31.940.800,Negative,"-0,2853"
24/12/2014,2675,2681,2663,2669,6,35.045.200,Positive,"0,8352"
29/12/2014,2681,2694,2656,2675,6,28.136.000,Positive,"0,9413"
30/12/2014,2694,2700,2669,2669,25,48.592.000,Positive,"0,2594"
02/01/2015,2706,2713,2688,2694,12,84.546.800,Positive,"0,369"
05/01/2015,2700,2713,2688,2713,-13,33.363.200,Negative,"-0,1099"
06/01/2015,2681,2706,2669,2688,-7,58.600.000,Negative,"-0,3883"
07/01/2015,2713,2713,2681,2688,25,50.244.400,Positive,"0,3621"
08/01/2015,2738,2744,2719,2725,13,63.649.600,Positive,"0,5819"
09/01/2015,2781,2806,2738,2750,31,170.824.800,Positive,"0,047"
12/01/2015,2706,2781,2706,2756,-50,53.126.800,Negative,"-0,3074"
13/01/2015,2688,2719,2656,2719,-31,80.360.800,Negative,"-0,1079"
14/01/2015,2681,2750,2681,2706,-25,59.552.800,Negative,"-0,3773"
15/01/2015,2725,2738,2688,2725,0,102.689.600,Positive,"0,5352"
16/01/2015,2675,2719,2675,2688,-13,95.469.200,Negative,"-0,4832"
19/01/2015,2681,2725,2663,2663,18,100.006.000,Positive,"0,741"
20/01/2015,2688,2688,2650,2669,19,146.990.400,Positive,"0,4181"
21/01/2015,2744,2744,2663,2688,56,74.948.000,Positive,"0,3494"
22/01/2015,2750,2756,2719,2744,6,71.265.600,Positive,"0,9769"
23/01/2015,2844,2844,2769,2769,75,134.785.600,Positive,"0,575"
26/01/2015,2775,2800,2725,2788,-13,150.832.800,Negative,"-0,4649"
27/01/2015,2769,2781,2750,2750,19,69.340.000,Positive,"0,1711"
28/01/2015,2744,2794,2744,2788,-44,64.691.600,Negative,"-0,4217"
29/01/2015,2744,2756,2731,2738,6,48.526.400,Positive,"0,9018"
30/01/2015,2750,2813,2750,2781,-31,98.195.200,Negative,"-0,2071"
02/02/2015,2813,2825,2738,2750,63,107.672.400,Positive,"0,3454"
03/02/2015,2838,2844,2819,2838,0,79.597.600,Positive,"0,8879"
04/02/2015,2844,2863,2800,2850,-6,135.804.000,Negative,"-0,3018"
05/02/2015,2813,2838,2806,2831,-18,111.271.200,Negative,"-0,3132"
06/02/2015,2838,2869,2825,2838,0,107.253.600,Positive,"0,4988"
09/02/2015,2925,2956,2850,2850,75,128.836.000,Positive,"0,1281"
10/02/2015,2906,2925,2888,2900,6,79.794.000,Positive,"0,5358"
11/02/2015,2938,2981,2925,2956,-18,123.487.600,Negative,"-0,2531"
12/02/2015,2944,2994,2938,2981,-37,98.841.600,Negative,"-0,1866"
13/02/2015,2975,2988,2963,2969,6,84.660.800,Positive,"0,9714"
16/02/2015,2944,2988,2938,2975,-31,85.716.800,Negative,"-0,3654"
17/02/2015,2925,2963,2913,2944,-19,28.532.800,Negative,"-0,1846"
18/02/2015,2981,3075,2969,3000,-19,167.238.000,Negative,"-0,4406"
20/02/2015,3019,3050,2994,2994,25,74.989.600,Positive,"0,4153"
23/02/2015,2969,3013,2956,2975,-6,118.434.000,Negative,"-0,2969"
24/02/2015,2969,2988,2944,2950,19,81.622.800,Positive,"0,5025"
25/02/2015,2975,2981,2963,2975,0,62.958.800,Positive,"0,3252"
26/02/2015,2969,2975,2950,2950,19,76.328.800,Positive,"0,7367"
27/02/2015,3000,3019,2950,2975,25,85.468.000,Positive,"0,8582"
02/03/2015,3000,3006,2975,2975,25,96.851.600,Positive,"0,4197"
03/03/2015,2975,3025,2975,3025,-50,57.682.400,Negative,"-0,3921"
04/03/2015,2963,2988,2956,2969,-6,47.226.000,Negative,"-0,1483"
05/03/2015,2956,2994,2950,2956,0,67.612.800,Positive,"0,172"
06/03/2015,3025,3025,2963,2975,50,77.888.400,Positive,"0,7326"
09/03/2015,2950,3006,2938,3000,-50,105.046.000,Negative,"-0,2368"
10/03/2015,3006,3019,2938,2956,50,69.672.800,Positive,"0,7605"
11/03/2015,2969,3006,2963,2975,-6,98.384.400,Negative,"-0,4584"
12/03/2015,2975,3006,2963,2963,12,45.096.400,Positive,"0,3966"
13/03/2015,2975,3013,2950,2994,-19,68.090.000,Negative,"-0,24"
16/03/2015,3000,3019,2963,2975,25,54.288.000,Positive,"0,5988"
17/03/2015,2994,3019,2981,3013,-19,51.684.800,Negative,"-0,167"
18/03/2015,2988,3000,2963,2963,25,54.372.400,Positive,"0,484"
19/03/2015,3050,3050,3000,3025,25,74.428.400,Positive,"0,5492"
20/03/2015,3050,3075,3019,3025,25,83.046.000,Positive,"0,6146"
23/03/2015,3044,3069,3044,3069,-25,36.825.600,Negative,"-0,1901"
24/03/2015,3019,3056,3013,3038,-19,59.234.400,Negative,"-0,4609"
25/03/2015,3006,3044,3000,3013,-7,59.409.600,Negative,"-0,4325"
26/03/2015,3013,3038,2988,3006,7,49.491.600,Positive,"0,7552"
27/03/2015,2988,3006,2963,2975,13,60.455.600,Positive,"0,6333"
30/03/2015,3025,3075,3000,3013,12,75.822.800,Positive,"0,9613"
31/03/2015,3119,3119,3063,3081,38,83.456.000,Positive,"0,6916"
01/04/2015,3069,3138,3025,3119,-50,110.690.000,Negative,"-0,3359"
02/04/2015,3069,3094,3006,3088,-19,56.737.600,Negative,"-0,3927"
06/04/2015,3044,3081,3025,3075,-31,64.304.400,Negative,"-0,4955"
07/04/2015,3044,3050,3019,3050,-6,95.657.600,Negative,"-0,2775"
08/04/2015,3019,3050,2994,3050,-31,113.430.800,Negative,"-0,3245"
09/04/2015,3000,3019,2988,3019,-19,62.660.800,Negative,"-0,3347"
10/04/2015,3000,3013,2994,3006,-6,52.790.800,Negative,"-0,4738"
13/04/2015,3013,3013,2988,3013,0,80.286.400,Positive,"0,4354"
14/04/2015,2963,3000,2944,2975,-12,104.148.800,Negative,"-0,4147"
15/04/2015,3013,3013,2956,2975,38,47.940.400,Positive,"0,0467"
16/04/2015,3000,3025,2994,3025,-25,55.566.800,Negative,"-0,1348"
17/04/2015,3000,3019,2981,3019,-19,40.751.200,Negative,"-0,225"
20/04/2015,3019,3019,2975,3000,19,44.488.800,Positive,"0,7987"
21/04/2015,3038,3038,3013,3025,13,69.309.200,Positive,"0,3117"
22/04/2015,3006,3038,3006,3038,-32,44.750.400,Negative,"-0,1103"
23/04/2015,3000,3013,2988,2994,6,64.157.200,Positive,"0,7569"
24/04/2015,2975,3019,2975,3006,-31,53.536.400,Negative,"-0,1663"
27/04/2015,2813,2950,2775,2950,-137,308.830.800,Negative,"-0,4048"
28/04/2015,2725,2744,2663,2725,0,279.868.000,Positive,"0,023"
29/04/2015,2638,2738,2588,2725,-87,316.523.200,Negative,"-0,1505"
30/04/2015,2688,2700,2619,2644,44,195.589.600,Positive,"0,1611"
04/05/2015,2794,2825,2675,2694,100,189.657.600,Positive,"0,1578"
05/05/2015,2806,2844,2781,2800,6,153.516.400,Positive,"0,326"
06/05/2015,2850,2850,2756,2756,94,128.029.200,Positive,"0,0588"
07/05/2015,2794,2838,2763,2781,13,111.124.000,Positive,"0,7462"
08/05/2015,2794,2838,2781,2831,-37,51.254.800,Negative,"-0,2457"
11/05/2015,2781,2825,2781,2794,-13,34.354.800,Negative,"-0,1186"
12/05/2015,2819,2838,2781,2794,25,96.191.200,Positive,"0,8844"
13/05/2015,2813,2825,2788,2788,25,138.148.400,Positive,"0,998"
15/05/2015,2738,2806,2731,2800,-62,102.507.600,Negative,"-0,1272"
18/05/2015,2775,2788,2738,2738,37,106.922.000,Positive,"0,9511"
19/05/2015,2800,2806,2763,2775,25,66.192.000,Positive,"0,653"
20/05/2015,2819,2838,2794,2825,-6,74.743.200,Negative,"-0,446"
21/05/2015,2906,2913,2813,2838,68,120.901.600,Positive,"0,5057"
22/05/2015,2856,2931,2838,2925,-69,83.152.000,Negative,"-0,2927"
25/05/2015,2788,2825,2781,2813,-25,100.023.600,Negative,"-0,2342"
26/05/2015,2781,2825,2781,2788,-7,88.446.000,Negative,"-0,1506"
27/05/2015,2750,2800,2750,2750,0,98.622.000,Positive,"0,8324"
28/05/2015,2700,2775,2688,2756,-56,160.551.600,Negative,"-0,3651"
29/05/2015,2694,2706,2681,2688,6,158.411.600,Positive,"0,0199"
01/06/2015,2675,2706,2650,2700,-25,116.245.200,Negative,"-0,3653"
03/06/2015,2638,2675,2613,2656,-18,145.928.400,Negative,"-0,1572"
04/06/2015,2631,2650,2600,2631,0,100.190.400,Positive,"0,7175"
05/06/2015,2669,2669,2613,2631,38,67.930.800,Positive,"0,9737"
08/06/2015,2575,2656,2563,2644,-69,97.918.000,Negative,"-0,2011"
09/06/2015,2488,2525,2425,2525,-37,196.405.200,Negative,"-0,2077"
10/06/2015,2469,2519,2431,2488,-19,110.615.600,Negative,"-0,3895"
11/06/2015,2419,2500,2406,2488,-69,106.057.200,Negative,"-0,422"
12/06/2015,2475,2494,2419,2425,50,108.184.000,Positive,"0,1651"
15/06/2015,2356,2463,2356,2450,-94,92.020.000,Negative,"-0,4626"
16/06/2015,2388,2419,2338,2375,13,93.402.800,Positive,"0,4664"
17/06/2015,2456,2488,2413,2413,43,170.708.800,Positive,"0,4189"
18/06/2015,2419,2494,2413,2475,-56,116.189.200,Negative,"-0,3947"
19/06/2015,2500,2513,2463,2475,25,139.460.400,Positive,"0,0557"
22/06/2015,2494,2525,2481,2519,-25,51.412.000,Negative,"-0,3492"
23/06/2015,2513,2519,2469,2500,13,115.338.000,Positive,"0,8793"
24/06/2015,2475,2563,2456,2525,-50,136.800.000,Negative,"-0,1474"
25/06/2015,2500,2544,2469,2488,12,127.306.400,Positive,"0,2001"
26/06/2015,2525,2538,2481,2519,6,42.988.000,Positive,"0,8818"
29/06/2015,2506,2513,2475,2488,18,51.673.600,Positive,"0,604"
30/06/2015,2513,2544,2488,2531,-18,66.377.600,Negative,"-0,1382"
01/07/2015,2500,2531,2494,2531,-31,68.338.800,Negative,"-0,3451"
02/07/2015,2519,2538,2475,2475,44,88.189.600,Positive,"0,3936"
03/07/2015,2544,2550,2500,2531,13,44.312.000,Positive,"0,1196"
06/07/2015,2481,2525,2475,2506,-25,40.962.400,Negative,"-0,1739"
07/07/2015,2538,2538,2500,2513,25,76.844.800,Positive,"0,8768"
08/07/2015,2488,2513,2475,2500,-12,68.092.000,Negative,"-0,4221"
09/07/2015,2475,2500,2456,2475,0,67.824.800,Positive,"0,3669"
10/07/2015,2500,2513,2488,2494,6,93.061.200,Positive,"0,1407"
13/07/2015,2513,2519,2494,2500,13,121.620.800,Positive,"0,2953"
14/07/2015,2531,2550,2519,2525,6,93.382.000,Positive,"0,5518"
15/07/2015,2500,2544,2488,2544,-44,58.466.000,Negative,"-0,2362"
22/07/2015,2600,2600,2531,2550,50,146.678.400,Positive,"0,8837"
23/07/2015,2525,2594,2525,2575,-50,80.344.400,Negative,"-0,3876"
24/07/2015,2500,2525,2488,2513,-13,101.181.200,Negative,"-0,2579"
27/07/2015,2388,2513,2381,2494,-106,139.128.000,Negative,"-0,368"
28/07/2015,2344,2356,2319,2344,0,107.764.400,Positive,"0,9483"
29/07/2015,2375,2388,2344,2363,12,111.259.600,Positive,"0,2119"
30/07/2015,2381,2413,2363,2400,-19,115.432.800,Negative,"-0,3709"
31/07/2015,2381,2394,2331,2375,6,226.184.800,Positive,"0,3063"
03/08/2015,2425,2431,2350,2350,75,189.702.800,Positive,"0,5203"
04/08/2015,2381,2444,2369,2425,-44,172.058.000,Negative,"-0,3853"
05/08/2015,2450,2450,2381,2400,50,182.880.400,Positive,"0,646"
06/08/2015,2450,2519,2438,2475,-25,138.502.000,Negative,"-0,4068"
07/08/2015,2413,2444,2406,2444,-31,60.834.400,Negative,"-0,367"
10/08/2015,2381,2438,2363,2438,-57,64.787.200,Negative,"-0,3527"
11/08/2015,2288,2413,2281,2406,-118,166.308.400,Negative,"-0,368"
12/08/2015,2200,2250,2131,2250,-50,199.885.200,Negative,"-0,1352"
13/08/2015,2275,2294,2213,2219,56,148.333.600,Positive,"0,7606"
14/08/2015,2250,2275,2238,2275,-25,122.529.600,Negative,"-0,3313"
18/08/2015,2200,2250,2188,2238,-38,83.244.000,Negative,"-0,1526"
19/08/2015,2175,2219,2156,2200,-25,92.040.000,Negative,"-0,1902"
20/08/2015,2175,2175,2131,2150,25,87.566.000,Positive,"0,7302"
21/08/2015,2125,2138,2100,2125,0,136.115.600,Positive,"0,0847"
24/08/2015,2044,2088,2031,2069,-25,129.089.600,Negative,"-0,3663"
25/08/2015,2125,2163,2050,2050,75,296.784.800,Positive,"0,8168"
26/08/2015,2138,2169,2088,2138,0,202.368.000,Positive,"0,4923"
27/08/2015,2250,2256,2175,2188,62,219.296.800,Positive,"0,8927"
28/08/2015,2269,2319,2244,2300,-31,174.394.000,Negative,"-0,1306"
31/08/2015,2275,2281,2238,2244,31,107.618.400,Positive,"0,9317"
01/09/2015,2181,2250,2169,2250,-69,74.196.800,Negative,"-0,3317"
02/09/2015,2200,2219,2150,2175,25,66.349.600,Positive,"0,9461"
03/09/2015,2206,2238,2194,2213,-7,95.144.800,Negative,"-0,3056"
04/09/2015,2206,2219,2181,2200,6,41.096.400,Positive,"0,8518"
07/09/2015,2188,2206,2175,2200,-12,54.352.800,Negative,"-0,4505"
08/09/2015,2200,2206,2175,2188,12,57.412.800,Positive,"0,3587"
09/09/2015,2175,2231,2150,2219,-44,135.401.200,Negative,"-0,3612"
10/09/2015,2150,2163,2138,2163,-13,70.959.200,Negative,"-0,1069"
11/09/2015,2163,2175,2163,2175,-12,46.889.600,Negative,"-0,3695"
14/09/2015,2163,2175,2150,2175,-12,41.073.600,Negative,"-0,2398"
15/09/2015,2175,2175,2150,2156,19,32.625.200,Positive,"0,2865"
16/09/2015,2163,2181,2150,2175,-12,32.254.800,Negative,"-0,4003"
17/09/2015,2163,2181,2150,2156,7,112.392.000,Positive,"0,1726"
18/09/2015,2163,2188,2156,2175,-12,94.615.200,Negative,"-0,3549"
21/09/2015,2150,2175,2150,2163,-13,66.774.000,Negative,"-0,252"
22/09/2015,2150,2163,2144,2150,0,34.276.400,Positive,"0,7043"
23/09/2015,2013,2125,2006,2125,-112,75.746.400,Negative,"-0,1681"
25/09/2015,1931,2000,1931,2000,-69,138.808.000,Negative,"-0,2747"
28/09/2015,1881,1944,1881,1931,-50,63.378.800,Negative,"-0,119"
29/09/2015,1944,1944,1788,1825,119,63.959.200,Positive,"0,0575"
30/09/2015,1981,2000,1956,1963,18,118.378.400,Positive,"0,5309"
01/10/2015,1994,2031,1981,2000,-6,63.633.600,Negative,"-0,2675"
02/10/2015,1919,2000,1919,1994,-75,89.269.200,Negative,"-0,3717"
05/10/2015,2050,2050,1950,1963,87,56.322.400,Positive,"0,4666"
06/10/2015,2225,2231,2075,2075,150,179.906.000,Positive,"0,4861"
07/10/2015,2231,2269,2175,2250,-19,118.109.200,Negative,"-0,3936"
08/10/2015,2225,2244,2200,2231,-6,108.926.400,Negative,"-0,4517"
09/10/2015,2275,2319,2256,2263,12,177.488.400,Positive,"0,9091"
12/10/2015,2294,2306,2250,2250,44,66.492.800,Positive,"0,4088"
13/10/2015,2238,2294,2238,2281,-43,123.736.400,Negative,"-0,3788"
15/10/2015,2225,2275,2213,2238,-13,80.592.800,Negative,"-0,3275"
16/10/2015,2231,2269,2225,2225,6,65.777.200,Positive,"0,1978"
19/10/2015,2288,2288,2238,2238,50,54.853.200,Positive,"0,7624"
20/10/2015,2313,2313,2256,2288,25,65.063.600,Positive,"0,6296"
21/10/2015,2306,2350,2281,2281,25,65.543.200,Positive,"0,0861"
22/10/2015,2294,2331,2294,2319,-25,66.396.000,Negative,"-0,4046"
23/10/2015,2350,2363,2300,2338,12,142.408.000,Positive,"0,2115"
26/10/2015,2394,2406,2369,2375,19,145.286.400,Positive,"0,7969"
27/10/2015,2413,2413,2356,2375,38,80.484.400,Positive,"0,1189"
28/10/2015,2363,2406,2363,2381,-18,72.526.000,Negative,"-0,3231"
29/10/2015,2250,2356,2238,2350,-100,113.545.600,Negative,"-0,4286"
30/10/2015,2175,2231,2175,2206,-31,183.069.200,Negative,"-0,4189"
02/11/2015,2138,2175,2100,2169,-31,84.406.800,Negative,"-0,4929"
03/11/2015,2213,2269,2175,2175,38,133.874.000,Positive,"0,2975"
04/11/2015,2275,2288,2219,2219,56,104.358.000,Positive,"0,8536"
05/11/2015,2244,2288,2225,2281,-37,76.689.200,Negative,"-0,3092"
06/11/2015,2244,2269,2225,2225,19,39.835.600,Positive,"0,5563"
09/11/2015,2175,2225,2175,2200,-25,66.005.200,Negative,"-0,1064"
10/11/2015,2100,2175,2100,2131,-31,122.132.000,Negative,"-0,307"
11/11/2015,2044,2088,2038,2081,-37,122.912.000,Negative,"-0,1214"
12/11/2015,2094,2113,2044,2044,50,101.481.200,Positive,"0,8388"
13/11/2015,2169,2169,2069,2075,94,86.066.400,Positive,"0,5678"
16/11/2015,2125,2131,2088,2113,12,54.983.200,Positive,"0,2642"
17/11/2015,2156,2169,2131,2131,25,75.114.400,Positive,"0,0284"
18/11/2015,2156,2175,2138,2175,-19,49.671.200,Negative,"-0,2606"
19/11/2015,2194,2194,2169,2175,19,61.782.000,Positive,"0,7575"
20/11/2015,2169,2188,2144,2163,6,54.798.400,Positive,"0,7364"
23/11/2015,2181,2213,2181,2181,0,45.954.000,Positive,"0,6023"
24/11/2015,2175,2188,2150,2150,25,26.436.400,Positive,"0,7151"
25/11/2015,2231,2238,2175,2181,50,65.648.400,Positive,"0,4145"
26/11/2015,2319,2319,2225,2244,75,114.857.200,Positive,"0,0867"
27/11/2015,2244,2319,2244,2306,-62,50.550.800,Negative,"-0,1393"
30/11/2015,2125,2250,2125,2225,-100,291.126.000,Negative,"-0,3474"
01/12/2015,2225,2244,2188,2188,37,81.230.800,Positive,"0,021"
02/12/2015,2225,2244,2213,2231,-6,45.067.200,Negative,"-0,3223"
03/12/2015,2200,2231,2200,2213,-13,46.170.000,Negative,"-0,4089"
04/12/2015,2188,2206,2175,2200,-12,66.563.200,Negative,"-0,3624"
07/12/2015,2275,2288,2206,2213,62,65.284.000,Positive,"0,0825"
08/12/2015,2250,2269,2225,2250,0,75.222.000,Positive,"0,8276"
09/12/2015,2250,2250,2250,2250,0,0,Positive,"0,8369"
10/12/2015,2219,2219,2188,2200,19,79.034.800,Positive,"0,1602"
11/12/2015,2188,2238,2188,2231,-43,45.985.200,Negative,"-0,4954"
14/12/2015,2156,2156,2113,2125,31,78.568.800,Positive,"0,0979"
15/12/2015,2188,2188,2144,2169,19,55.228.000,Positive,"0,6862"
16/12/2015,2238,2238,2188,2213,25,87.191.200,Positive,"0,4825"
17/12/2015,2275,2288,2244,2288,-13,90.298.000,Negative,"-0,348"
18/12/2015,2181,2244,2181,2244,-63,93.092.000,Negative,"-0,1166"
21/12/2015,2219,2219,2181,2181,38,16.910.000,Positive,"0,3258"
22/12/2015,2219,2231,2200,2231,-12,44.916.000,Negative,"-0,1196"
23/12/2015,2219,2225,2188,2213,6,51.713.200,Positive,"0,5565"
28/12/2015,2250,2269,2175,2175,75,66.709.200,Positive,"0,7719"
29/12/2015,2281,2281,2269,2269,12,43.552.000,Positive,"0,1234"
30/12/2015,2313,2313,2275,2281,32,104.390.800,Positive,"0,4094"
04/01/2016,2313,2338,2269,2300,13,60.667.600,Neutral,0.0
05/01/2016,2344,2388,2313,2313,31,106.152.400,Neutral,0.0
06/01/2016,2338,2381,2338,2363,-25,106.147.600,Neutral,0.0
07/01/2016,2275,2313,2275,2288,-13,92.196.400,Neutral,0.0
08/01/2016,2319,2319,2275,2275,44,97.109.200,Neutral,0.0
11/01/2016,2275,2288,2250,2275,0,62.974.000,Neutral,0.0
12/01/2016,2300,2319,2275,2300,0,77.847.200,Neutral,0.0
13/01/2016,2338,2363,2300,2319,19,132.198.400,Neutral,0.0
14/01/2016,2338,2369,2275,2275,63,120.844.000,Positive,"0,8699"
15/01/2016,2319,2356,2319,2338,-19,41.635.600,Negative,"-0,2371"
18/01/2016,2319,2331,2313,2313,6,61.618.000,Positive,"0,5829"
19/01/2016,2344,2350,2306,2306,38,33.891.200,Positive,"0,7208"
20/01/2016,2331,2350,2325,2331,0,111.518.800,Neutral,0.0
21/01/2016,2325,2344,2313,2331,-6,111.117.200,Neutral,0.0
22/01/2016,2344,2350,2319,2325,19,102.318.000,Neutral,0.0
25/01/2016,2381,2388,2344,2350,31,52.867.200,Positive,"0,4223"
26/01/2016,2381,2388,2356,2363,18,68.705.200,Positive,"0,9963"
27/01/2016,2388,2400,2363,2388,0,97.861.600,Neutral,0.0
28/01/2016,2375,2388,2356,2388,-13,84.751.600,Neutral,0.0
29/01/2016,2400,2400,2356,2375,25,118.885.600,Neutral,0.0
01/02/2016,2406,2413,2344,2400,6,73.618.400,Negative,-0.3612
02/02/2016,2375,2400,2350,2394,-19,50.634.000,Neutral,0.0
03/02/2016,2344,2356,2338,2350,-6,62.028.400,Neutral,0.0
04/02/2016,2400,2444,2350,2369,31,176.216.000,Neutral,0.0
05/02/2016,2588,2600,2400,2400,188,244.064.000,Neutral,0.0
09/02/2016,2513,2569,2513,2550,-37,56.263.200,Neutral,0.0
10/02/2016,2456,2525,2450,2500,-44,56.126.000,Neutral,0.0
11/02/2016,2500,2506,2456,2456,44,144.164.400,Neutral,0.0
12/02/2016,2431,2488,2413,2475,-44,136.429.600,Neutral,0.0
15/02/2016,2450,2456,2431,2450,0,110.414.800,Neutral,0.0
16/02/2016,2438,2463,2431,2456,-18,90.171.200,Negative,-0.296
17/02/2016,2425,2450,2419,2431,-6,103.568.000,Neutral,0.0
18/02/2016,2431,2469,2425,2444,-13,205.636.800,Neutral,0.0
19/02/2016,2325,2369,2300,2369,-44,381.658.000,Negative,"-0,3489"
22/02/2016,2350,2369,2306,2306,44,122.025.200,Neutral,0.0
23/02/2016,2313,2344,2294,2313,0,78.939.200,Neutral,0.0
24/02/2016,2350,2375,2319,2338,12,76.399.200,Neutral,0.0
25/02/2016,2331,2363,2313,2350,-19,59.981.600,Neutral,0.0
26/02/2016,2369,2381,2344,2344,25,59.542.000,Neutral,0.0
29/02/2016,2388,2388,2344,2369,19,109.371.200,Positive,"0,8866"
01/03/2016,2363,2388,2344,2369,-6,75.571.600,Neutral,0.0
02/03/2016,2406,2431,2375,2388,18,125.545.600,Neutral,0.0
03/03/2016,2425,2444,2400,2425,0,80.812.000,Neutral,0.0
04/03/2016,2444,2444,2406,2425,19,69.759.600,Neutral,0.0
07/03/2016,2494,2500,2450,2463,31,176.466.000,Positive,"0,2753"
08/03/2016,2500,2506,2475,2500,0,145.376.000,Neutral,0.0
10/03/2016,2525,2525,2450,2450,75,124.006.000,Neutral,0.0
11/03/2016,2525,2525,2525,2525,0,0,Neutral,0.0
14/03/2016,2525,2525,2525,2525,0,0,Positive,"0,9188"
15/03/2016,2544,2563,2538,2563,-19,57.556.000,Negative,"-0,2604"
16/03/2016,2544,2550,2500,2550,-6,46.800.000,Neutral,0.0
17/03/2016,2525,2563,2500,2563,-38,75.276.400,Neutral,0.0
18/03/2016,2525,2544,2500,2544,-19,110.007.200,Neutral,0.0
21/03/2016,2538,2550,2525,2525,13,137.365.600,Neutral,0.0
22/03/2016,2575,2581,2544,2550,25,87.624.800,Neutral,0.0
23/03/2016,2563,2581,2550,2581,-18,103.693.600,Neutral,0.0
24/03/2016,2556,2581,2550,2550,6,115.484.400,Neutral,0.0
28/03/2016,2519,2556,2506,2544,-25,71.154.000,Negative,-0.2023
29/03/2016,2550,2550,2500,2519,31,90.892.400,Positive,0.4939
30/03/2016,2588,2588,2513,2525,63,178.441.600,Neutral,0.0
31/03/2016,2575,2594,2550,2588,-13,103.862.400,Negative,"-0,353"
01/04/2016,2525,2569,2481,2556,-31,60.710.400,Neutral,0.0
04/04/2016,2544,2544,2519,2525,19,36.848.800,Positive,"0,3004"
05/04/2016,2594,2600,2538,2550,44,99.461.600,Positive,0.4939
06/04/2016,2594,2613,2569,2613,-19,39.915.200,Neutral,0.0
07/04/2016,2575,2613,2538,2613,-38,70.107.200,Positive,0.296
08/04/2016,2463,2525,2444,2513,-50,181.048.000,Positive,0.296
11/04/2016,2463,2463,2463,2463,0,0,Neutral,0.0
12/04/2016,2388,2413,2363,2381,7,153.933.200,Positive,0.2263
13/04/2016,2388,2388,2388,2388,0,0,Negative,-0.2023
14/04/2016,2388,2388,2388,2388,0,0,Neutral,0.0
15/04/2016,2388,2388,2388,2388,0,0,Positive,"0,7869"
18/04/2016,2388,2388,2388,2388,0,0,Neutral,0.0
19/04/2016,2388,2388,2388,2388,0,0,Neutral,0.0
20/04/2016,2438,2450,2400,2406,32,88.110.800,Negative,-0.1779
21/04/2016,2469,2481,2438,2438,31,78.975.600,Positive,0.4939
22/04/2016,2494,2500,2450,2469,25,70.598.400,Neutral,0.0
25/04/2016,2419,2488,2381,2488,-69,100.451.600,Neutral,0.0
26/04/2016,2375,2400,2319,2400,-25,143.723.600,Positive,0.4939
27/04/2016,2406,2413,2344,2350,56,77.419.600,Neutral,0.0
28/04/2016,2456,2456,2406,2413,43,70.421.200,Neutral,0.0
29/04/2016,2413,2431,2388,2419,-6,51.991.600,Neutral,0.0
02/05/2016,2388,2413,2350,2406,-18,39.910.400,Negative,"-0,406"
03/05/2016,2463,2469,2413,2425,38,87.932.400,Positive,"0,0403"
04/05/2016,2425,2450,2400,2444,-19,86.007.600,Negative,"-0,108"
09/05/2016,2325,2406,2288,2400,-75,173.752.800,Negative,"-0,4961"
10/05/2016,2363,2375,2313,2325,38,96.082.400,Positive,"0,1964"
11/05/2016,2406,2425,2369,2406,0,61.418.400,Positive,"0,8823"
12/05/2016,2375,2419,2363,2419,-44,40.284.400,Negative,"-0,3858"
13/05/2016,2325,2375,2288,2350,-25,86.747.200,Negative,"-0,1001"
16/05/2016,2256,2288,2244,2275,-19,132.095.200,Negative,"-0,1402"
17/05/2016,2188,2225,2169,2213,-25,238.361.200,Negative,"-0,3411"
18/05/2016,2200,2231,2163,2175,25,120.478.400,Positive,"0,8864"
19/05/2016,2238,2256,2206,2213,25,128.139.600,Positive,"0,7648"
20/05/2016,2175,2238,2169,2238,-63,102.942.800,Negative,"-0,2331"
23/05/2016,2213,2225,2188,2194,19,60.646.400,Positive,"0,8619"
24/05/2016,2213,2231,2206,2219,-6,68.519.600,Negative,"-0,3619"
25/05/2016,2269,2269,2238,2244,25,65.183.200,Positive,"0,5405"
26/05/2016,2250,2281,2231,2269,-19,110.522.400,Negative,"-0,2041"
27/05/2016,2263,2275,2225,2225,38,42.332.800,Positive,"0,3284"
30/05/2016,2319,2331,2275,2281,38,52.332.000,Positive,"0,1929"
31/05/2016,2256,2319,2256,2319,-63,121.300.000,Negative,"-0,4966"
01/06/2016,2300,2319,2250,2250,50,54.789.600,Positive,0.1779
02/06/2016,2306,2313,2281,2300,6,37.745.200,Positive,"0,5187"
03/06/2016,2281,2325,2269,2325,-44,41.559.200,Neutral,0.0
06/06/2016,2319,2325,2281,2288,31,35.986.000,Neutral,0.0
07/06/2016,2369,2375,2331,2344,25,89.779.200,Positive,0.1779
08/06/2016,2375,2375,2331,2331,44,47.643.200,Positive,"0,0113"
09/06/2016,2319,2356,2319,2338,-19,49.185.600,Neutral,0.0
10/06/2016,2319,2350,2313,2331,-12,38.004.800,Neutral,0.0
13/06/2016,2263,2306,2256,2300,-37,47.977.600,Negative,-0.2732
14/06/2016,2244,2263,2225,2256,-12,69.002.400,Negative,-0.1779
15/06/2016,2250,2275,2231,2238,12,53.459.200,Neutral,0.0
16/06/2016,2238,2275,2225,2256,-18,70.762.400,Positive,0.4404
17/06/2016,2238,2250,2219,2250,-12,72.084.000,Negative,"-0,4291"
20/06/2016,2269,2300,2238,2275,-6,92.255.600,Neutral,0.0
21/06/2016,2250,2294,2250,2288,-38,48.328.800,Neutral,0.0
22/06/2016,2250,2275,2250,2263,-13,64.551.200,Neutral,0.0
23/06/2016,2269,2275,2250,2250,19,39.572.800,Neutral,0.0
24/06/2016,2263,2288,2213,2288,-25,108.756.400,Neutral,0.0
27/06/2016,2250,2256,2231,2250,0,30.060.400,Neutral,0.0
28/06/2016,2363,2375,2231,2250,113,180.226.800,Neutral,0.0
29/06/2016,2400,2400,2369,2375,25,119.147.200,Neutral,0.0
30/06/2016,2381,2425,2375,2413,-32,94.406.800,Negative,"-0,1572"
01/07/2016,2350,2388,2331,2375,-25,60.738.800,Neutral,0.0
11/07/2016,2425,2438,2350,2350,75,214.285.200,Neutral,0.0
12/07/2016,2544,2544,2444,2444,100,210.138.400,Neutral,0.0
13/07/2016,2475,2544,2463,2475,0,180.907.600,Negative,-0.1779
14/07/2016,2400,2463,2400,2456,-56,156.016.400,Neutral,0.0
15/07/2016,2419,2431,2400,2406,13,101.136.000,Positive,"0,1755"
18/07/2016,2419,2425,2394,2400,19,70.528.800,Positive,"0,8252"
19/07/2016,2525,2525,2400,2413,112,221.550.000,Neutral,0.0
20/07/2016,2606,2619,2525,2525,81,189.806.800,Neutral,0.0
21/07/2016,2531,2606,2506,2606,-75,136.153.200,Negative,"-0,1372"
22/07/2016,2481,2544,2475,2544,-63,63.128.000,Negative,"-0,3899"
25/07/2016,2481,2506,2456,2488,-7,69.858.000,Neutral,0.0
26/07/2016,2463,2481,2450,2469,-6,106.499.600,Neutral,0.0
27/07/2016,2525,2581,2469,2469,56,267.820.000,Positive,0.2023
28/07/2016,2525,2538,2500,2531,-6,103.855.200,Positive,0.5574
29/07/2016,2525,2569,2513,2525,0,184.920.800,Neutral,0.0
01/08/2016,2638,2663,2550,2556,82,259.045.600,Positive,"0,3716"
02/08/2016,2663,2694,2638,2663,0,248.454.400,Positive,"0,6516"
03/08/2016,2606,2663,2600,2663,-57,66.817.200,Negative,"-0,3405"
04/08/2016,2638,2650,2606,2638,0,138.364.800,Positive,0.4939
05/08/2016,2850,2850,2650,2656,194,271.034.000,Neutral,0.0
08/08/2016,2913,2919,2863,2875,38,167.230.400,Positive,"0,8412"
09/08/2016,2950,2988,2913,2913,37,135.220.000,Neutral,0.0
10/08/2016,2888,2919,2869,2913,-25,68.758.800,Neutral,0.0
11/08/2016,2794,2875,2763,2863,-69,96.170.000,Neutral,0.0
12/08/2016,2769,2838,2719,2813,-44,221.792.400,Positive,0.3818
15/08/2016,2794,2800,2725,2756,38,66.988.000,Neutral,0.0
16/08/2016,2831,2838,2788,2800,31,101.694.000,Neutral,0.0
18/08/2016,2856,2863,2831,2838,18,122.375.200,Neutral,0.0
19/08/2016,2863,2906,2838,2856,7,118.537.600,Neutral,0.0
22/08/2016,2850,2869,2825,2856,-6,96.936.400,Neutral,0.0
23/08/2016,2825,2888,2800,2863,-38,106.780.000,Positive,0.6808
24/08/2016,2838,2881,2831,2838,0,75.942.800,Neutral,0.0
25/08/2016,2850,2881,2838,2838,12,76.602.000,Neutral,0.0
26/08/2016,2850,2888,2825,2888,-38,37.491.600,Neutral,0.0
29/08/2016,2794,2813,2763,2800,-6,109.065.200,Neutral,0.0
30/08/2016,2819,2819,2763,2775,44,80.098.800,Positive,"0,043"
31/08/2016,2806,2838,2775,2775,31,89.442.400,Positive,"0,0425"
01/09/2016,2769,2806,2763,2775,-6,50.065.600,Neutral,0.0
02/09/2016,2794,2800,2719,2719,75,42.616.400,Neutral,0.0
05/09/2016,2794,2831,2794,2825,-31,43.328.000,Negative,"-0,2985"
06/09/2016,2794,2800,2756,2775,19,53.300.400,Neutral,0.0
07/09/2016,2819,2819,2781,2781,38,63.607.200,Neutral,0.0
08/09/2016,2800,2813,2781,2794,6,27.072.800,Positive,0.6369
09/09/2016,2713,2800,2706,2775,-62,99.994.000,Neutral,0.0
13/09/2016,2669,2706,2625,2669,0,83.080.000,Neutral,0.0
14/09/2016,2650,2700,2631,2631,19,70.232.000,Neutral,0.0
15/09/2016,2744,2800,2650,2681,63,87.249.200,Neutral,0.0
16/09/2016,2769,2813,2750,2775,-6,116.464.800,Negative,-0.2023
19/09/2016,2806,2825,2781,2794,12,39.174.800,Positive,0.1779
20/09/2016,2850,2850,2813,2825,25,45.393.600,Positive,0.34
21/09/2016,2844,2875,2794,2806,38,64.057.200,Neutral,0.0
22/09/2016,2913,2913,2856,2875,38,84.429.200,Neutral,0.0
23/09/2016,2875,2925,2869,2875,0,80.014.800,Neutral,0.0
26/09/2016,2913,2919,2856,2900,13,54.502.000,Neutral,0.0
27/09/2016,2938,2938,2850,2913,25,132.846.400,Positive,"0,5222"
28/09/2016,2825,2875,2800,2863,-38,248.204.400,Negative,"-0,3895"
29/09/2016,2856,2863,2831,2831,25,153.378.800,Neutral,0.0
30/09/2016,2800,2844,2788,2838,-38,134.034.000,Neutral,0.0
03/10/2016,2819,2838,2788,2831,-12,72.856.400,Negative,"-0,3573"
04/10/2016,2800,2825,2794,2819,-19,84.598.000,Neutral,0.0
05/10/2016,2750,2794,2744,2781,-31,145.494.400,Negative,"-0,4574"
06/10/2016,2738,2769,2719,2750,-12,103.363.600,Neutral,0.0
07/10/2016,2725,2738,2706,2706,19,57.687.200,Neutral,0.0
10/10/2016,2725,2763,2725,2744,-19,56.290.400,Neutral,0.0
11/10/2016,2713,2750,2700,2731,-18,89.322.800,Negative,"-0,2816"
12/10/2016,2750,2756,2688,2688,62,58.748.000,Positive,"0,4289"
13/10/2016,2763,2781,2719,2756,7,74.737.200,Positive,"0,7225"
14/10/2016,2838,2844,2756,2763,75,94.256.800,Positive,"0,2293"
17/10/2016,2844,2863,2813,2813,31,67.042.000,Positive,"0,1478"
18/10/2016,2850,2875,2850,2863,-13,56.909.600,Negative,"-0,2896"
19/10/2016,2844,2863,2831,2844,0,51.456.800,Positive,"0,939"
20/10/2016,2825,2856,2825,2850,-25,53.644.400,Positive,0.1779
21/10/2016,2806,2850,2806,2850,-44,50.378.800,Neutral,0.0
24/10/2016,2800,2844,2800,2806,-6,63.450.800,Negative,"-0,2017"
25/10/2016,2794,2825,2788,2806,-12,73.782.400,Neutral,0.0
26/10/2016,2769,2800,2706,2756,13,141.981.200,Neutral,0.0
27/10/2016,2831,2844,2769,2769,62,69.336.400,Negative,-0.1779
28/10/2016,2844,2856,2831,2850,-6,43.510.800,Neutral,0.0
31/10/2016,2869,2913,2850,2850,19,132.730.800,Positive,"0,8774"
01/11/2016,2856,2906,2856,2869,-13,74.071.200,Neutral,0.0
02/11/2016,2875,2888,2856,2856,19,72.401.600,Neutral,0.0
03/11/2016,2788,2875,2788,2863,-75,91.768.800,Neutral,0.0
04/11/2016,2775,2819,2738,2750,25,58.732.400,Neutral,0.0
07/11/2016,2844,2850,2781,2825,19,69.898.800,Neutral,0.0
08/11/2016,2894,2913,2856,2863,31,82.063.200,Positive,0.34
09/11/2016,2838,2975,2813,2913,-75,114.585.600,Negative,-0.2023
10/11/2016,2856,2906,2856,2900,-44,54.770.400,Negative,"-0,1174"
11/11/2016,2713,2794,2713,2781,-68,200.151.200,Negative,"-0,4923"
14/11/2016,2581,2688,2513,2675,-94,193.930.000,Neutral,0.0
15/11/2016,2638,2669,2581,2600,38,84.936.400,Neutral,0.0
16/11/2016,2706,2738,2650,2650,56,51.892.800,Neutral,0.0
17/11/2016,2725,2725,2669,2719,6,52.244.800,Positive,0.4939
18/11/2016,2731,2738,2688,2738,-7,42.805.200,Neutral,0.0
21/11/2016,2675,2700,2669,2675,0,82.676.800,Positive,"0,8688"
22/11/2016,2731,2731,2675,2675,56,71.874.000,Positive,"0,8184"
23/11/2016,2725,2731,2675,2694,31,69.157.200,Neutral,0.0
24/11/2016,2525,2681,2506,2675,-150,230.784.000,Neutral,0.0
25/11/2016,2538,2569,2506,2544,-6,112.994.800,Neutral,0.0
28/11/2016,2538,2544,2506,2538,0,111.426.000,Neutral,0.0
29/11/2016,2581,2600,2538,2538,43,83.037.200,Negative,-0.2023
30/11/2016,2625,2656,2600,2600,25,157.626.400,Positive,"0,5547"
01/12/2016,2625,2675,2625,2625,0,112.836.400,Positive,"0,4446"
02/12/2016,2675,2694,2625,2663,12,74.612.800,Positive,"0,7885"
05/12/2016,2663,2681,2650,2650,13,43.111.200,Positive,"0,1868"
06/12/2016,2663,2706,2644,2700,-37,95.774.000,Negative,"-0,2154"
07/12/2016,2675,2675,2656,2663,12,42.293.200,Positive,"0,6329"
08/12/2016,2738,2738,2681,2694,44,62.835.600,Positive,"0,4136"
09/12/2016,2744,2750,2700,2700,44,64.734.800,Positive,"0,9522"
13/12/2016,2706,2731,2688,2731,-25,52.023.200,Neutral,0.0
14/12/2016,2719,2744,2700,2719,0,40.252.400,Neutral,0.0
15/12/2016,2700,2713,2650,2675,25,55.218.400,Neutral,0.0
16/12/2016,2688,2713,2688,2700,-12,70.044.800,Neutral,0.0
19/12/2016,2706,2725,2688,2688,18,23.188.800,Negative,-0.2023
20/12/2016,2700,2719,2688,2688,12,33.521.600,Neutral,0.0
21/12/2016,2688,2706,2688,2688,0,46.268.800,Neutral,0.0
22/12/2016,2688,2706,2675,2688,0,97.122.800,Neutral,0.0
23/12/2016,2694,2738,2681,2688,6,54.570.000,Neutral,0.0
27/12/2016,2700,2713,2688,2694,6,38.650.800,Neutral,0.0
28/12/2016,2788,2788,2719,2738,50,47.457.600,Positive,0.6249
29/12/2016,2894,2894,2775,2800,94,77.951.200,Neutral,0.0
30/12/2016,2894,2931,2838,2894,0,136.139.600,Neutral,0.0
02/01/2017,2894,2894,2894,2894,0,0,Positive,"0,5608"
03/01/2017,2825,2894,2800,2894,-69,50.412.000,Negative,"-0,4941"
04/01/2017,2838,2838,2781,2825,13,41.110.400,Positive,"0,5866"
05/01/2017,2813,2831,2788,2800,13,66.554.400,Positive,"0,9667"
06/01/2017,2844,2856,2819,2838,6,54.337.600,Positive,"0,6809"
09/01/2017,2819,2856,2806,2856,-37,36.349.200,Negative,"-0,2116"
10/01/2017,2850,2850,2813,2844,6,24.804.800,Positive,"0,5073"
11/01/2017,2844,2900,2844,2856,-12,68.727.200,Negative,"-0,2111"
12/01/2017,2825,2869,2825,2850,-25,29.136.000,Negative,"-0,292"
13/01/2017,2775,2869,2775,2869,-94,56.228.800,Negative,"-0,1797"
16/01/2017,2731,2813,2725,2813,-82,77.629.200,Negative,"-0,2362"
17/01/2017,2731,2756,2725,2725,6,62.045.200,Positive,"0,1501"
18/01/2017,2763,2781,2738,2750,13,94.687.200,Positive,"0,2954"
19/01/2017,2763,2794,2750,2775,-12,72.744.000,Negative,"-0,4358"
20/01/2017,2750,2769,2738,2763,-13,40.007.200,Negative,"-0,4105"
23/01/2017,2744,2763,2725,2725,19,16.690.800,Positive,"0,7736"
24/01/2017,2750,2763,2738,2750,0,83.274.400,Positive,"0,0899"
25/01/2017,2750,2763,2744,2763,-13,76.550.000,Negative,"-0,4798"
26/01/2017,2725,2756,2725,2738,-13,49.446.000,Negative,"-0,4782"
27/01/2017,2744,2756,2738,2744,0,24.174.800,Positive,"0,7435"
30/01/2017,2756,2769,2744,2763,-7,35.440.400,Negative,"-0,3747"
31/01/2017,2725,2756,2725,2725,0,38.055.600,Positive,"0,226"
01/02/2017,2744,2756,2731,2744,0,117.245.600,Positive,"0,2501"
02/02/2017,2750,2763,2738,2744,6,79.610.000,Positive,"0,8307"
03/02/2017,2769,2775,2750,2769,0,111.316.000,Positive,"0,2891"
06/02/2017,2844,2850,2788,2788,56,198.014.400,Positive,"0,413"
07/02/2017,2850,2863,2831,2844,6,117.718.800,Positive,"0,7149"
08/02/2017,2806,2838,2794,2838,-32,109.655.200,Negative,"-0,3116"
09/02/2017,2869,2894,2850,2850,19,97.844.000,Positive,"0,8864"
10/02/2017,2850,2900,2838,2900,-50,96.540.400,Negative,"-0,1364"
13/02/2017,2863,2900,2856,2894,-31,81.397.200,Negative,"-0,1194"
14/02/2017,2856,2869,2838,2863,-7,79.745.200,Negative,"-0,4148"
15/02/2017,2856,2856,2856,2856,0,0,Positive,"0,7002"
16/02/2017,2800,2838,2725,2825,-25,207.778.000,Negative,"-0,3179"
17/02/2017,2769,2800,2750,2800,-31,103.224.000,Negative,"-0,1326"
20/02/2017,2819,2819,2775,2800,19,72.190.000,Positive,"0,8742"
21/02/2017,2788,2825,2775,2825,-37,50.008.400,Negative,"-0,4433"
22/02/2017,2825,2825,2775,2813,12,106.237.200,Positive,"0,352"
23/02/2017,2788,2819,2788,2788,0,43.852.800,Positive,"0,1621"
24/02/2017,2775,2819,2775,2819,-44,59.158.000,Negative,"-0,2288"
27/02/2017,2794,2806,2794,2794,0,30.397.600,Positive,"0,9419"
28/02/2017,2825,2850,2800,2825,0,43.444.400,Positive,"0,1587"
01/03/2017,2838,2850,2806,2850,-12,91.156.400,Negative,"-0,2636"
02/03/2017,2831,2863,2831,2844,-13,57.482.800,Negative,"-0,2356"
03/03/2017,2838,2844,2800,2813,25,29.331.600,Positive,"0,9962"
06/03/2017,2825,2844,2806,2838,-13,42.578.400,Negative,"-0,4125"
07/03/2017,2831,2838,2800,2800,31,86.823.200,Positive,"0,1997"
08/03/2017,2831,2850,2831,2844,-13,33.371.200,Negative,"-0,2286"
09/03/2017,2844,2844,2813,2844,0,14.298.400,Positive,"0,1795"
10/03/2017,2850,2850,2831,2850,0,22.744.800,Positive,"0,68"
13/03/2017,2850,2850,2800,2800,50,45.914.400,Positive,"0,7662"
14/03/2017,2856,2863,2825,2825,31,32.416.800,Positive,"0,4025"
15/03/2017,2863,2894,2844,2875,-12,38.783.600,Negative,"-0,2008"
16/03/2017,2894,2913,2881,2894,0,124.136.800,Positive,"0,6435"
17/03/2017,2906,2925,2888,2913,-7,115.811.200,Negative,"-0,4803"
20/03/2017,2944,2975,2906,2931,13,84.118.000,Positive,"0,8163"
21/03/2017,2950,2975,2938,2963,-13,98.651.200,Negative,"-0,4156"
22/03/2017,2944,2956,2869,2888,56,137.866.400,Positive,"0,5674"
23/03/2017,2975,3006,2963,2963,12,164.951.600,Positive,"0,2969"
24/03/2017,2975,2994,2938,2994,-19,101.622.400,Negative,"-0,1649"
27/03/2017,2925,2963,2925,2925,0,43.376.800,Positive,"0,102"
29/03/2017,2944,2975,2919,2975,-31,55.658.000,Negative,"-0,4701"
30/03/2017,2944,2963,2906,2944,0,32.161.600,Positive,"0,9351"
31/03/2017,2925,2944,2925,2938,-13,63.985.600,Negative,"-0,1514"
03/04/2017,2938,2963,2900,2950,-12,58.964.400,Negative,"-0,1358"
04/04/2017,2938,2988,2913,2913,25,77.408.800,Positive,"0,8738"
05/04/2017,2938,2938,2938,2938,0,0,Positive,"0,1573"
06/04/2017,3106,3106,2956,2975,131,87.415.600,Positive,"0,2859"
07/04/2017,3050,3106,3050,3075,-25,79.835.600,Negative,"-0,2832"
10/04/2017,3013,3069,2988,3056,-43,36.636.800,Negative,"-0,2676"
11/04/2017,2938,3000,2925,3000,-62,43.113.200,Negative,"-0,1981"
12/04/2017,2925,2950,2919,2919,6,32.561.600,Positive,"0,0367"
13/04/2017,2913,2963,2875,2950,-37,56.194.400,Negative,"-0,4723"
17/04/2017,2906,2925,2881,2925,-19,19.153.200,Negative,"-0,1562"
18/04/2017,2938,2963,2906,2925,13,89.368.000,Positive,"0,9394"
19/04/2017,2938,2938,2938,2938,0,0,Positive,"0,9214"
20/04/2017,2881,2938,2863,2925,-44,81.478.400,Negative,"-0,4163"
21/04/2017,2850,2919,2850,2894,-44,38.329.600,Negative,"-0,3264"
25/04/2017,2888,2925,2869,2894,-6,149.208.000,Negative,"-0,4604"
26/04/2017,2956,3069,2925,2925,31,319.850.400,Neutral,0.0
27/04/2017,2931,2963,2925,2925,6,106.382.000,Positive,0.2263
28/04/2017,2925,2938,2913,2919,6,83.747.600,Neutral,0.0
02/05/2017,2919,2931,2919,2925,-6,83.054.400,Negative,-0.2263
03/05/2017,2894,2913,2875,2913,-19,99.818.800,Negative,-0.1779
04/05/2017,2925,2956,2906,2906,19,134.070.000,Positive,"0,6951"
05/05/2017,2994,3031,2938,2938,56,146.848.400,Neutral,0.0
08/05/2017,3013,3069,3013,3025,-12,150.575.200,Neutral,0.0
09/05/2017,3000,3038,3000,3013,-13,60.982.800,Neutral,0.0
10/05/2017,3006,3025,2981,3025,-19,78.420.400,Neutral,0.0
12/05/2017,3000,3044,2988,3044,-44,97.264.400,Neutral,0.0
15/05/2017,3031,3031,2988,3025,6,45.706.000,Neutral,0.0
16/05/2017,2994,3038,2988,3031,-37,75.918.000,Neutral,0.0
17/05/2017,3000,3013,2950,2994,6,84.887.200,Neutral,0.0
18/05/2017,3038,3038,2963,3000,38,35.564.400,Positive,0.1779
19/05/2017,3225,3319,2994,3038,187,113.093.200,Neutral,0.0
22/05/2017,3131,3325,3100,3300,-169,102.829.200,Neutral,0.0
23/05/2017,3063,3144,3025,3131,-68,73.616.400,Neutral,0.0
24/05/2017,3100,3100,3000,3013,87,50.502.800,Neutral,0.0
26/05/2017,3038,3125,3025,3119,-81,57.578.000,Neutral,0.0
29/05/2017,3088,3100,3038,3075,13,46.570.000,Neutral,0.0
30/05/2017,3106,3119,3063,3063,43,40.218.400,Positive,0.1779
31/05/2017,3150,3150,3088,3125,25,85.243.600,Positive,"0,5234"
01/06/2017,3150,3150,3150,3150,0,0,Positive,"0,6475"
02/06/2017,3150,3213,3125,3213,-63,59.829.200,Negative,"-0,4607"
05/06/2017,3169,3194,3144,3150,19,47.045.600,Positive,"0,7915"
06/06/2017,3125,3181,3094,3144,-19,28.721.200,Negative,"-0,1058"
07/06/2017,3100,3125,3088,3088,12,49.372.000,Positive,"0,6737"
08/06/2017,3081,3100,3050,3088,-7,71.202.800,Negative,"-0,3444"
09/06/2017,3056,3113,3050,3075,-19,32.254.000,Negative,"-0,4664"
12/06/2017,3056,3081,3056,3069,-13,25.720.400,Neutral,0.0
13/06/2017,3063,3106,3038,3038,25,33.952.400,Neutral,0.0
14/06/2017,3125,3138,3075,3081,44,47.202.400,Neutral,0.0
15/06/2017,3125,3188,3113,3125,0,93.786.800,Neutral,0.0
16/06/2017,3119,3125,3081,3113,6,87.512.000,Neutral,0.0
19/06/2017,3119,3131,3100,3119,0,30.677.600,Neutral,0.0
20/06/2017,3131,3131,3069,3113,18,69.688.000,Neutral,0.0
21/06/2017,3175,3175,3106,3113,62,194.634.400,Neutral,0.0
22/06/2017,3188,3188,3138,3175,13,140.644.400,Neutral,0.0
23/06/2017,3188,3188,3188,3188,0,0,Neutral,0.0
26/06/2017,3188,3188,3188,3188,0,0,Positive,"0,4599"
27/06/2017,3188,3188,3188,3188,0,0,Positive,"0,78"
28/06/2017,3188,3188,3188,3188,0,0,Positive,"0,7332"
29/06/2017,3188,3188,3188,3188,0,0,Positive,"0,0407"
30/06/2017,3188,3188,3188,3188,0,0,Positive,"0,1093"
03/07/2017,3375,3375,3169,3194,181,116.340.400,Neutral,0.0
04/07/2017,3375,3375,3300,3331,44,65.585.600,Neutral,0.0
05/07/2017,3331,3369,3306,3369,-38,156.807.200,Neutral,0.0
06/07/2017,3331,3363,3325,3331,0,68.512.000,Neutral,0.0
07/07/2017,3313,3344,3275,3275,38,94.396.000,Neutral,0.0
10/07/2017,3275,3325,3250,3250,25,44.828.000,Positive,"0,2405"
11/07/2017,3244,3263,3219,3250,-6,49.422.400,Negative,"-0,4611"
12/07/2017,3306,3313,3213,3213,93,33.112.400,Positive,"0,8796"
13/07/2017,3350,3350,3263,3325,25,102.872.000,Positive,"0,6484"
14/07/2017,3388,3388,3300,3363,25,23.547.200,Positive,"0,7604"
17/07/2017,3394,3394,3363,3388,6,28.083.200,Positive,"0,8925"
18/07/2017,3381,3381,3356,3375,6,17.110.400,Positive,"0,24"
19/07/2017,3331,3394,3313,3394,-63,47.982.400,Negative,"-0,364"
20/07/2017,3375,3375,3325,3331,44,31.556.800,Positive,"0,9577"
21/07/2017,3263,3375,3263,3331,-68,62.956.800,Neutral,0.0
24/07/2017,3319,3319,3250,3256,63,68.629.600,Neutral,0.0
25/07/2017,3338,3338,3275,3275,63,56.757.200,Positive,0.1779
26/07/2017,3338,3363,3300,3300,38,114.075.600,Neutral,0.0
27/07/2017,3344,3363,3325,3338,6,74.731.600,Neutral,0.0
28/07/2017,3344,3363,3306,3363,-19,87.392.800,Neutral,0.0
31/07/2017,3413,3413,3325,3350,63,85.417.600,Neutral,0.0
01/08/2017,3350,3419,3350,3419,-69,29.979.200,Negative,-0.2732
02/08/2017,3319,3375,3313,3319,0,65.299.600,Negative,-0.2732
03/08/2017,3281,3325,3275,3300,-19,75.375.200,Neutral,0.0
04/08/2017,3269,3331,3263,3263,6,62.769.600,Neutral,0.0
07/08/2017,3294,3306,3263,3263,31,71.766.800,Neutral,0.0
08/08/2017,3356,3356,3288,3294,62,58.065.600,Neutral,0.0
09/08/2017,3350,3375,3313,3363,-13,49.458.800,Neutral,0.0
10/08/2017,3331,3375,3319,3375,-44,41.486.400,Neutral,0.0
11/08/2017,3300,3325,3288,3313,-13,111.049.200,Neutral,0.0
14/08/2017,3313,3325,3300,3300,13,77.951.600,Neutral,0.0
15/08/2017,3325,3331,3319,3331,-6,47.208.800,Negative,"-0,2147"
16/08/2017,3331,3331,3313,3331,0,40.337.200,Neutral,0.0
17/08/2017,3331,3331,3331,3331,0,0,Negative,-0.1027
18/08/2017,3275,3300,3269,3300,-25,143.414.400,Neutral,0.0
21/08/2017,3300,3313,3263,3263,37,56.732.800,Positive,"0,2509"
22/08/2017,3313,3325,3313,3325,-12,37.080.400,Neutral,0.0
23/08/2017,3319,3344,3300,3338,-19,46.171.200,Neutral,0.0
24/08/2017,3300,3325,3300,3325,-25,84.711.600,Neutral,0.0
25/08/2017,3294,3338,3294,3338,-44,45.026.400,Neutral,0.0
28/08/2017,3306,3319,3300,3313,-7,15.407.600,Neutral,0.0
29/08/2017,3275,3306,3275,3294,-19,83.386.400,Neutral,0.0
30/08/2017,3275,3294,3269,3275,0,48.228.400,Positive,"0,052"
31/08/2017,3275,3294,3269,3269,6,69.100.800,Positive,"0,6516"
01/09/2017,3275,3275,3275,3275,0,0,Positive,"0,001"
04/09/2017,3263,3281,3244,3263,0,69.268.400,Positive,"0,7869"
05/09/2017,3269,3269,3219,3250,19,53.423.200,Positive,"0,4511"
06/09/2017,3238,3256,3200,3225,13,126.368.400,Positive,"0,7415"
07/09/2017,3256,3263,3225,3263,-7,45.544.400,Negative,"-0,475"
08/09/2017,3319,3331,3250,3269,50,92.788.000,Positive,"0,2741"
11/09/2017,3300,3325,3300,3319,-19,51.046.400,Negative,-0.2732
12/09/2017,3300,3331,3294,3325,-25,51.482.000,Neutral,0.0
13/09/2017,3288,3350,3275,3350,-62,22.269.800,Positive,0.1779
14/09/2017,3275,3325,3275,3313,-38,32.387.000,Negative,"-0,3705"
15/09/2017,3313,3338,3263,3275,38,96.577.000,Positive,"0,0029"
18/09/2017,3288,3313,3250,3275,13,31.203.000,Neutral,0.0
19/09/2017,3300,3313,3263,3300,0,65.627.600,Positive,0.2023
20/09/2017,3300,3313,3275,3288,12,152.308.200,Neutral,0.0
21/09/2017,3300,3300,3300,3300,0,0,Positive,"0,5447"
22/09/2017,3300,3325,3275,3300,0,88.331.600,Positive,0.3818
25/09/2017,3288,3325,3275,3300,-12,55.045.800,Negative,"-0,2051"
26/09/2017,3275,3300,3275,3300,-25,94.085.400,Negative,"-0,3379"
27/09/2017,3300,3300,3263,3288,12,121.814.200,Positive,"0,2344"
28/09/2017,3288,3313,3288,3300,-12,56.049.600,Neutral,0.0
29/09/2017,3363,3388,3288,3288,75,175.719.200,Negative,-0.2732
02/10/2017,3350,3375,3313,3363,-13,41.590.800,Neutral,0.0
03/10/2017,3350,3375,3325,3350,0,59.653.400,Positive,"0,8334"
04/10/2017,3325,3363,3325,3363,-38,43.641.800,Negative,"-0,2998"
05/10/2017,3300,3350,3288,3338,-38,77.918.000,Negative,"-0,1515"
06/10/2017,3300,3313,3288,3300,0,22.471.200,Neutral,0.0
09/10/2017,3300,3325,3288,3325,-25,21.028.600,Positive,0.4019
10/10/2017,3350,3363,3300,3325,25,53.161.200,Negative,-0.2732
11/10/2017,3363,3388,3338,3363,0,117.588.400,Positive,"0,3941"
12/10/2017,3413,3438,3338,3375,38,167.578.400,Positive,"0,8382"
13/10/2017,3388,3500,3388,3425,-37,98.661.000,Negative,"-0,3918"
16/10/2017,3463,3563,3438,3438,25,177.292.000,Positive,"0,3211"
17/10/2017,3513,3538,3475,3538,-25,112.955.000,Negative,"-0,4689"
18/10/2017,3538,3550,3513,3550,-12,152.454.400,Negative,"-0,2702"
19/10/2017,3488,3538,3463,3538,-50,78.878.400,Negative,"-0,294"
20/10/2017,3550,3563,3475,3488,62,55.557.200,Positive,"0,808"
23/10/2017,3475,3550,3450,3538,-63,65.908.600,Positive,0.2263
24/10/2017,3413,3500,3413,3450,-37,44.982.200,Negative,-0.1779
25/10/2017,3500,3525,3475,3475,25,166.683.400,Negative,-0.2023
26/10/2017,3513,3550,3488,3525,-12,91.155.200,Negative,"-0,1605"
27/10/2017,3475,3563,3475,3500,-25,63.364.400,Negative,"-0,4697"
30/10/2017,3538,3563,3488,3550,-12,107.043.000,Negative,"-0,4121"
31/10/2017,3525,3575,3500,3563,-38,78.930.400,Negative,"-0,3187"
01/11/2017,3550,3550,3513,3550,0,43.310.400,Positive,"0,1497"
02/11/2017,3638,3713,3563,3575,63,68.625.800,Neutral,0.0
03/11/2017,3625,3688,3563,3675,-50,78.730.200,Neutral,0.0
06/11/2017,3613,3675,3575,3575,38,59.551.800,Neutral,0.0
07/11/2017,3563,3638,3538,3613,-50,56.480.400,Neutral,0.0
08/11/2017,3588,3600,3550,3575,13,80.597.600,Neutral,0.0
09/11/2017,3538,3600,3538,3588,-50,170.971.800,Neutral,0.0
10/11/2017,3525,3563,3513,3550,-25,84.111.200,Negative,-0.3612
13/11/2017,3525,3550,3475,3550,-25,33.709.000,Negative,"-0,3671"
14/11/2017,3475,3550,3475,3500,-25,59.334.000,Negative,"-0,4501"
15/11/2017,3488,3525,3463,3525,-37,81.461.200,Negative,"-0,2081"
16/11/2017,3550,3563,3463,3463,87,79.021.400,Positive,"0,2637"
17/11/2017,3663,3700,3563,3588,75,96.578.200,Positive,"0,7655"
20/11/2017,3713,3738,3650,3688,25,53.410.000,Positive,"0,9705"
21/11/2017,3700,3725,3663,3725,-25,191.716.800,Negative,"-0,3641"
22/11/2017,3688,3800,3688,3750,-62,72.659.600,Negative,"-0,4123"
23/11/2017,3725,3763,3688,3763,-38,55.739.600,Negative,"-0,1897"
24/11/2017,3725,3750,3688,3750,-25,36.058.400,Neutral,0.0
27/11/2017,3713,3738,3688,3725,-12,122.810.200,Neutral,0.0
28/11/2017,3713,3725,3700,3700,13,68.486.600,Positive,0.3818
29/11/2017,3700,3738,3700,3738,-38,139.273.800,Neutral,0.0
30/11/2017,3700,3800,3688,3700,0,167.540.000,Positive,"0,1015"
01/12/2017,3700,3700,3700,3700,0,0,Positive,"0,2638"
04/12/2017,3725,3750,3700,3750,-25,73.258.000,Neutral,0.0
05/12/2017,3738,3763,3713,3738,0,65.673.400,Neutral,0.0
06/12/2017,3738,3763,3725,3750,-12,47.704.000,Negative,"-0,1538"
07/12/2017,3675,3738,3675,3725,-50,50.580.000,Negative,"-0,1212"
08/12/2017,3738,3763,3688,3750,-12,33.166.400,Negative,"-0,4015"
11/12/2017,3738,3775,3725,3763,-25,17.030.400,Negative,"-0,2323"
12/12/2017,3725,3775,3700,3775,-50,51.088.800,Negative,"-0,259"
13/12/2017,3738,3750,3700,3700,38,54.077.800,Positive,"0,8076"
14/12/2017,3738,3775,3713,3750,-12,122.524.400,Negative,"-0,3442"
15/12/2017,3713,3738,3650,3700,13,94.872.200,Positive,"0,062"
18/12/2017,3750,3750,3650,3663,87,33.166.000,Positive,"0,4977"
19/12/2017,3738,3763,3675,3688,50,70.926.400,Positive,"0,7464"
20/12/2017,3725,3763,3688,3763,-38,79.075.800,Negative,"-0,3315"
21/12/2017,3813,3850,3750,3775,38,88.489.000,Negative,-0.2732
22/12/2017,3838,3850,3775,3813,25,158.513.400,Neutral,0.0
25/12/2017,3838,3838,3838,3838,0,0,Positive,"0,648"
26/12/2017,3838,3838,3838,3838,0,0,Neutral,0.0
27/12/2017,4000,4025,3838,3838,162,53.968.200,Neutral,0.0
28/12/2017,3975,4050,3925,3988,-13,251.049.600,Negative,-0.2732
29/12/2017,4000,4038,3900,4025,-25,78.314.600,Positive,0.25
01/01/2018,4000,4000,4000,4000,0,0,Neutral,0.0
02/01/2018,3925,4025,3913,3988,-63,59.351.600,Neutral,0.0
03/01/2018,3850,3925,3825,3925,-75,84.278.000,Neutral,0.0
04/01/2018,3913,3913,3863,3875,38,90.123.000,Neutral,0.0
05/01/2018,3913,3925,3863,3863,50,75.378.600,Neutral,0.0
08/01/2018,3963,3975,3913,3938,25,73.784.000,Positive,"0,6802"
09/01/2018,3950,4000,3888,3988,-38,67.352.000,Negative,"-0,3818"
10/01/2018,3950,3963,3900,3963,-13,68.746.400,Negative,"-0,1507"
11/01/2018,4038,4038,3963,3963,75,89.346.200,Positive,"0,5483"
12/01/2018,4050,4125,4000,4038,12,84.306.400,Positive,"0,0393"
15/01/2018,4100,4100,4025,4075,25,38.412.200,Positive,0.2732
16/01/2018,4113,4150,4075,4075,38,46.720.000,Neutral,0.0
17/01/2018,4050,4113,4013,4113,-63,56.945.400,Negative,-0.2732
18/01/2018,4063,4088,4025,4075,-12,53.685.800,Neutral,0.0
19/01/2018,4038,4088,4025,4088,-50,50.158.600,Neutral,0.0
22/01/2018,4038,4075,4025,4075,-37,91.243.800,Neutral,0.0
23/01/2018,4088,4088,4038,4088,0,111.192.600,Positive,"0,0107"
24/01/2018,4125,4125,4075,4100,25,84.633.200,Positive,"0,5921"
25/01/2018,4075,4138,4038,4125,-50,65.155.800,Negative,"-0,2499"
26/01/2018,4100,4125,4063,4100,0,69.599.800,Positive,"0,7228"
29/01/2018,4088,4125,3950,4113,-25,101.413.600,Negative,"-0,462"
30/01/2018,4025,4050,3988,4038,-13,102.154.200,Negative,"-0,3624"
31/01/2018,4075,4088,3975,3988,87,79.788.400,Positive,"0,3454"
01/02/2018,4100,4125,4063,4100,0,72.274.400,Positive,"0,6442"
02/02/2018,4063,4113,4063,4100,-37,60.042.800,Negative,"-0,2467"
05/02/2018,4063,4075,3988,4025,38,63.620.600,Positive,"0,7082"
06/02/2018,4013,4050,3963,4000,13,92.415.600,Positive,"0,2487"
07/02/2018,4063,4075,4038,4050,13,57.427.400,Positive,"0,0188"
08/02/2018,4088,4125,4025,4100,-12,79.067.200,Negative,"-0,2175"
09/02/2018,4113,4113,4025,4038,75,211.953.600,Positive,"0,799"
12/02/2018,4100,4125,4038,4113,-13,72.517.000,Negative,"-0,162"
13/02/2018,4138,4150,4100,4100,38,75.870.600,Positive,"0,17"
14/02/2018,4150,4163,4113,4150,0,26.730.800,Positive,"0,7638"
15/02/2018,4150,4188,4075,4188,-38,65.557.000,Negative,"-0,1322"
16/02/2018,4150,4150,4150,4150,0,0,Positive,"0,9898"
19/02/2018,4238,4238,4138,4175,63,49.342.200,Positive,"0,5798"
20/02/2018,4525,4525,4213,4263,262,79.298.400,Neutral,0.0
21/02/2018,4400,4463,4375,4450,-50,83.845.600,Neutral,0.0
22/02/2018,4313,4438,4288,4438,-125,39.301.400,Neutral,0.0
23/02/2018,4275,4350,4250,4288,-13,62.711.800,Negative,"-0,3106"
26/02/2018,4150,4300,4150,4300,-150,66.541.400,Negative,"-0,1209"
27/02/2018,4213,4263,4163,4213,0,92.994.400,Positive,"0,4229"
28/02/2018,4150,4238,4150,4238,-88,81.356.600,Negative,"-0,3884"
01/03/2018,4188,4225,4163,4200,-12,50.682.200,Negative,"-0,2669"
02/03/2018,4238,4238,4113,4163,75,49.761.400,Positive,"0,1178"
05/03/2018,4113,4213,4100,4188,-75,44.376.600,Negative,"-0,342"
06/03/2018,4025,4150,4000,4138,-113,77.337.000,Negative,"-0,185"
07/03/2018,3963,4063,3850,4013,-50,116.997.600,Negative,"-0,1427"
08/03/2018,4050,4088,4000,4000,50,86.635.600,Positive,"0,7269"
09/03/2018,4050,4088,4000,4025,25,46.391.000,Positive,"0,5725"
12/03/2018,4163,4163,4075,4100,63,78.310.600,Neutral,0.0
13/03/2018,4088,4138,4025,4113,-25,79.622.600,Negative,-0.2732
14/03/2018,4100,4113,3988,4113,-13,41.997.000,Neutral,0.0
15/03/2018,4000,4088,4000,4088,-88,66.507.000,Positive,0.4588
16/03/2018,3963,3975,3850,3950,13,155.572.000,Negative,-0.34
19/03/2018,4038,4063,3963,4013,25,95.158.400,Neutral,0.0
20/03/2018,4050,4075,3925,3975,75,77.864.800,Positive,"0,73"
21/03/2018,4100,4113,4050,4100,0,113.297.400,Positive,"0,6952"
22/03/2018,4000,4125,3975,4125,-125,183.372.000,Negative,"-0,139"
23/03/2018,4025,4025,3850,3900,125,90.662.600,Positive,"0,4995"
26/03/2018,4038,4038,3925,3925,113,42.673.400,Positive,"0,965"
27/03/2018,4000,4075,3975,4063,-63,55.450.200,Negative,"-0,1899"
28/03/2018,3900,3988,3863,3975,-75,76.203.200,Negative,"-0,4762"
29/03/2018,3838,3838,3763,3825,13,78.477.600,Positive,0.3182
30/03/2018,3838,3838,3838,3838,0,0,Neutral,0.0
02/04/2018,3913,3913,3788,3788,125,31.435.200,Neutral,0.0
03/04/2018,3900,3900,3838,3863,37,47.967.200,Neutral,0.0
04/04/2018,3800,3913,3775,3913,-113,38.287.200,Neutral,0.0
05/04/2018,3825,3875,3763,3875,-50,54.709.000,Negative,"-0,1174"
06/04/2018,3775,3813,3750,3775,0,45.831.200,Positive,"0,6401"
09/04/2018,3788,3825,3750,3825,-37,32.505.800,Negative,"-0,1909"
10/04/2018,3938,3938,3775,3775,163,87.487.000,Positive,"0,4357"
11/04/2018,4025,4038,3963,3975,50,58.578.400,Positive,"0,9782"
12/04/2018,4013,4013,3925,4000,13,56.053.600,Positive,"0,4551"
13/04/2018,4013,4050,3963,4050,-37,33.896.200,Negative,"-0,4819"
16/04/2018,4013,4013,4013,4013,0,0,Positive,"0,5657"
17/04/2018,4013,4013,4013,4013,0,0,Positive,"0,1065"
18/04/2018,4025,4025,3950,3975,50,28.595.200,Positive,"0,4754"
19/04/2018,4025,4025,4025,4025,0,0,Positive,"0,9842"
20/04/2018,4025,4025,4025,4025,0,0,Positive,"0,3697"
23/04/2018,4000,4000,3925,3938,62,62.793.000,Positive,"0,0243"
24/04/2018,3863,4000,3863,4000,-137,49.193.400,Negative,"-0,1887"
25/04/2018,3863,3863,3863,3863,0,0,Positive,"0,6379"
26/04/2018,3863,3863,3863,3863,0,0,Positive,"0,1784"
27/04/2018,3863,3863,3863,3863,0,0,Neutral,0.0
30/04/2018,3563,3575,3438,3500,63,94.666.400,Neutral,0.0
01/05/2018,3563,3563,3563,3563,0,0,Positive,"0,5127"
02/05/2018,3600,3613,3488,3563,37,53.590.000,Neutral,0.0
03/05/2018,3425,3588,3425,3575,-150,104.380.400,Neutral,0.0
04/05/2018,3313,3450,3300,3425,-112,54.995.600,Negative,"-0,1431"
07/05/2018,3400,3438,3300,3300,100,66.820.800,Neutral,0.0
08/05/2018,3400,3413,3338,3400,0,106.457.400,Neutral,0.0
09/05/2018,3588,3588,3363,3363,225,111.977.600,Neutral,0.0
10/05/2018,3588,3588,3588,3588,0,0,Positive,"0,2867"
11/05/2018,3600,3738,3575,3625,-25,103.564.000,Neutral,0.0
14/05/2018,3600,3650,3475,3650,-50,73.256.600,Negative,"-0,1056"
15/05/2018,3425,3600,3400,3500,-75,117.942.000,Negative,"-0,223"
16/05/2018,3425,3438,3300,3350,75,171.743.000,Positive,1
17/05/2018,3350,3500,3350,3475,-125,108.035.800,Negative,"-0,2335"
18/05/2018,3400,3450,3325,3388,12,73.179.600,Positive,"0,9237"
21/05/2018,3338,3388,3300,3363,-25,93.035.200,Negative,"-0,1101"
22/05/2018,3263,3388,3263,3375,-112,95.244.600,Neutral,0.0
23/05/2018,3388,3438,3300,3300,88,98.477.800,Negative,-0.25
24/05/2018,3500,3538,3425,3500,0,105.512.200,Neutral,0.0
25/05/2018,3500,3538,3475,3525,-25,87.283.000,Neutral,0.0
28/05/2018,3688,3713,3550,3575,113,129.253.400,Positive,"0,6449"
29/05/2018,3688,3688,3688,3688,0,0,Positive,"0,1568"
30/05/2018,3625,3813,3575,3613,12,170.628.800,Positive,"0,4084"
31/05/2018,3525,3700,3513,3700,-175,211.020.800,Negative,"-0,1039"
01/06/2018,3525,3525,3525,3525,0,0,Positive,"0,3587"
04/06/2018,3688,3713,3550,3550,138,80.221.000,Neutral,0.0
05/06/2018,3675,3725,3638,3725,-50,73.520.200,Negative,-0.3818
06/06/2018,3663,3688,3650,3650,13,72.158.600,Neutral,0.0
07/06/2018,3688,3700,3663,3688,0,49.787.600,Neutral,0.0
08/06/2018,3475,3700,3475,3700,-225,134.418.800,Negative,"-0,4996"
11/06/2018,3475,3475,3475,3475,0,0,Positive,"0,5326"
12/06/2018,3475,3475,3475,3475,0,0,Positive,"0,0136"
13/06/2018,3475,3475,3475,3475,0,0,Positive,"0,7756"
14/06/2018,3475,3475,3475,3475,0,0,Positive,"0,9116"
15/06/2018,3475,3475,3475,3475,0,0,Positive,"0,4675"
18/06/2018,3475,3475,3475,3475,0,0,Positive,"0,9138"
19/06/2018,3475,3475,3475,3475,0,0,Positive,"0,8369"
20/06/2018,3350,3425,3250,3425,-75,170.142.400,Negative,"-0,2753"
21/06/2018,3350,3388,3288,3350,0,109.648.600,Positive,"0,0036"
22/06/2018,3350,3363,3300,3350,0,90.954.000,Positive,"0,7684"
25/06/2018,3350,3388,3288,3375,-25,59.331.600,Negative,"-0,3894"
26/06/2018,3313,3375,3288,3288,25,55.935.600,Positive,"0,3283"
27/06/2018,3300,3350,3300,3325,-25,51.148.600,Negative,"-0,3519"
28/06/2018,3250,3363,3213,3363,-113,109.565.000,Negative,-0.4767
29/06/2018,3425,3425,3300,3375,50,82.868.000,Positive,0.5267
02/07/2018,3263,3488,3263,3488,-225,55.579.800,Neutral,0.0
03/07/2018,3163,3288,3163,3238,-75,74.286.400,Neutral,0.0
04/07/2018,3300,3313,3138,3200,100,54.066.400,Positive,"0,5687"
05/07/2018,3263,3300,3175,3250,13,49.814.600,Negative,-0.1779
06/07/2018,3150,3238,3150,3200,-50,51.696.400,Negative,-0.0516
09/07/2018,3213,3263,3150,3175,38,111.683.800,Neutral,0.0
10/07/2018,3225,3288,3188,3250,-25,87.662.000,Positive,0.1779
11/07/2018,3175,3188,3125,3150,25,71.600.600,Neutral,0.0
12/07/2018,3225,3225,3150,3150,75,69.482.600,Neutral,0.0
13/07/2018,3300,3325,3213,3213,87,71.123.600,Positive,0.5106
16/07/2018,3275,3313,3188,3275,0,57.879.600,Positive,"0,5906"
17/07/2018,3163,3238,3150,3225,-62,84.860.000,Negative,"-0,2559"
18/07/2018,3200,3213,3150,3163,37,46.293.000,Positive,"0,8546"
19/07/2018,3188,3263,3188,3213,-25,69.942.000,Negative,"-0,4764"
20/07/2018,3175,3225,3138,3213,-38,101.994.800,Neutral,0.0
23/07/2018,3200,3288,3188,3200,0,80.140.200,Neutral,0.0
24/07/2018,3263,3263,3200,3250,13,38.980.400,Positive,0.5106
25/07/2018,3238,3275,3225,3275,-37,62.149.400,Positive,0.3818
26/07/2018,3275,3275,3238,3250,25,57.947.800,Negative,-0.2263
27/07/2018,3288,3288,3250,3288,0,35.688.800,Neutral,0.0
30/07/2018,3363,3363,3275,3288,75,54.608.200,Neutral,0.0
31/07/2018,3325,3363,3288,3363,-38,66.929.400,Negative,"-0,1669"
01/08/2018,3500,3500,3338,3350,150,110.824.000,Positive,"0,9719"
02/08/2018,3525,3588,3463,3500,25,61.392.400,Positive,"0,6139"
03/08/2018,3600,3613,3500,3500,100,63.550.400,Positive,"0,2002"
06/08/2018,3650,3713,3600,3613,37,102.478.600,Positive,"0,9216"
07/08/2018,3600,3713,3600,3650,-50,102.967.800,Negative,"-0,2324"
08/08/2018,3663,3663,3550,3613,50,48.967.400,Positive,"0,4369"
09/08/2018,3638,3675,3600,3600,38,28.914.800,Positive,"0,3997"
10/08/2018,3675,3713,3650,3663,12,36.267.800,Positive,"0,0414"
13/08/2018,3463,3625,3425,3600,-137,82.658.400,Negative,-0.1779
14/08/2018,3363,3450,3350,3438,-75,122.915.000,Neutral,0.0
15/08/2018,3400,3413,3263,3375,25,82.042.800,Negative,-0.2263
16/08/2018,3350,3388,3300,3375,-25,42.463.600,Negative,-0.1779
17/08/2018,3350,3350,3350,3350,0,0,Positive,"0,9217"
20/08/2018,3363,3475,3350,3475,-112,81.139.200,Neutral,0.0
21/08/2018,3350,3388,3338,3375,-25,62.399.200,Neutral,0.0
22/08/2018,3350,3350,3350,3350,0,0,Positive,"0,0028"
23/08/2018,3425,3425,3350,3400,25,98.059.800,Positive,"0,7081"
24/08/2018,3388,3425,3375,3400,-12,75.683.200,Negative,"-0,472"
27/08/2018,3488,3488,3388,3413,75,84.503.200,Positive,"0,5752"
28/08/2018,3500,3513,3450,3500,0,80.591.200,Positive,"0,9339"
29/08/2018,3500,3513,3463,3488,12,55.272.600,Neutral,0.0
30/08/2018,3425,3513,3400,3500,-75,52.753.200,Negative,-0.2732
31/08/2018,3450,3450,3338,3350,100,110.408.200,Neutral,0.0
03/09/2018,3350,3450,3350,3450,-100,55.590.200,Negative,-0.2732
04/09/2018,3288,3375,3225,3363,-75,59.803.000,Neutral,0.0
05/09/2018,3163,3263,3100,3250,-87,83.838.600,Neutral,0.0
06/09/2018,3275,3275,3100,3100,175,96.306.200,Neutral,0.0
07/09/2018,3313,3325,3225,3250,63,75.525.400,Neutral,0.0
10/09/2018,3288,3300,3213,3250,38,37.301.800,Negative,-0.2732
11/09/2018,3288,3288,3288,3288,0,0,Neutral,0.0
12/09/2018,3188,3313,3188,3288,-100,46.357.000,Neutral,0.0
13/09/2018,3288,3313,3225,3238,50,36.668.600,Positive,0.5267
14/09/2018,3375,3375,3300,3338,37,30.656.000,Neutral,0.0
17/09/2018,3225,3338,3213,3325,-100,88.368.200,Negative,-0.2732
18/09/2018,3188,3263,3163,3225,-37,101.172.800,Neutral,0.0
19/09/2018,3200,3225,3188,3225,-25,42.616.400,Neutral,0.0
20/09/2018,3338,3338,3213,3213,125,99.827.000,Positive,0.5106
21/09/2018,3425,3475,3363,3375,50,124.841.800,Positive,0.5267
24/09/2018,3375,3450,3338,3425,-50,81.188.200,Neutral,0.0
25/09/2018,3313,3375,3263,3338,-25,46.091.400,Negative,-0.2732
26/09/2018,3300,3363,3288,3288,12,32.016.600,Neutral,0.0
27/09/2018,3313,3363,3275,3300,13,82.349.800,Positive,"0,0793"
28/09/2018,3363,3375,3300,3300,63,101.686.800,Neutral,0.0
01/10/2018,3350,3400,3300,3300,50,66.513.400,Neutral,0.0
02/10/2018,3225,3350,3213,3350,-125,120.652.800,Neutral,0.0
03/10/2018,3250,3288,3200,3200,50,68.383.400,Positive,"0,2128"
04/10/2018,3113,3213,3113,3200,-87,116.478.400,Neutral,0.0
05/10/2018,3138,3175,3088,3113,25,67.792.400,Positive,0.3182
08/10/2018,3100,3150,3100,3138,-38,55.327.600,Negative,-0.2732
09/10/2018,3175,3188,3100,3100,75,40.331.400,Positive,0.1779
10/10/2018,3238,3263,3188,3200,38,39.230.800,Neutral,0.0
11/10/2018,3138,3175,3100,3125,13,64.054.000,Neutral,0.0
12/10/2018,3200,3238,3138,3138,62,70.448.200,Neutral,0.0
15/10/2018,3188,3263,3188,3250,-62,40.880.400,Neutral,0.0
16/10/2018,3250,3250,3200,3200,50,29.777.600,Neutral,0.0
17/10/2018,3288,3325,3263,3300,-12,43.108.000,Negative,"-0,3523"
18/10/2018,3250,3300,3200,3250,0,39.270.000,Neutral,0.0
19/10/2018,3225,3250,3188,3225,0,47.990.000,Neutral,0.0
22/10/2018,3225,3263,3188,3225,0,36.415.600,Neutral,0.0
23/10/2018,3213,3238,3213,3225,-12,25.707.400,Positive,0.2023
24/10/2018,3163,3238,3163,3213,-50,33.969.400,Neutral,0.0
25/10/2018,3238,3238,3125,3125,113,62.781.600,Positive,"0,9283"
26/10/2018,3225,3250,3200,3238,-13,39.723.200,Negative,"-0,2706"
29/10/2018,3200,3250,3200,3213,-13,40.472.000,Negative,"-0,3037"
30/10/2018,3263,3263,3213,3250,13,34.731.200,Positive,"0,9187"
31/10/2018,3425,3425,3275,3288,137,111.265.400,Neutral,0.0
01/11/2018,3613,3675,3438,3450,163,185.151.800,Positive,0.296
02/11/2018,3713,3750,3550,3663,50,143.785.200,Positive,0.1779
05/11/2018,3688,3700,3625,3700,-12,56.013.400,Positive,0.5994
06/11/2018,3675,3738,3625,3738,-63,124.000.800,Neutral,0.0
07/11/2018,3675,3700,3600,3688,-13,92.281.000,Positive,0.2263
08/11/2018,3750,3763,3688,3700,50,130.444.200,Neutral,0.0
09/11/2018,3613,3663,3575,3625,-12,123.465.600,Neutral,0.0
12/11/2018,3488,3613,3488,3613,-125,65.689.800,Negative,"-0,4886"
13/11/2018,3575,3588,3400,3400,175,85.750.000,Positive,"0,7244"
14/11/2018,3563,3650,3563,3638,-75,68.203.400,Negative,"-0,4826"
15/11/2018,3700,3725,3575,3625,75,115.193.000,Positive,"0,8587"
16/11/2018,3725,3813,3688,3738,-13,113.146.000,Negative,"-0,3592"
19/11/2018,3738,3788,3650,3750,-12,52.926.800,Negative,"-0,4544"
20/11/2018,3738,3738,3738,3738,0,0,Positive,0.5106
21/11/2018,3638,3663,3525,3613,25,121.808.800,Positive,0.5106
22/11/2018,3663,3700,3588,3638,25,89.601.400,Positive,0.5106
23/11/2018,3650,3700,3638,3675,-25,82.350.000,Negative,-0.1027
26/11/2018,3688,3700,3625,3625,63,62.934.800,Positive,0.6369
27/11/2018,3725,3750,3675,3688,37,61.028.800,Neutral,0.0
28/11/2018,3700,3750,3663,3750,-50,67.675.000,Neutral,0.0
29/11/2018,3825,3825,3750,3750,75,141.202.600,Positive,"0,0197"
30/11/2018,3700,3813,3700,3788,-88,148.482.800,Positive,0.1779
03/12/2018,3800,3863,3775,3775,25,136.684.600,Neutral,0.0
04/12/2018,3825,3825,3775,3788,37,60.153.200,Positive,"0,4646"
05/12/2018,3788,3800,3763,3800,-12,73.322.400,Neutral,0.0
06/12/2018,3738,3763,3700,3700,38,74.092.000,Neutral,0.0
07/12/2018,3750,3813,3738,3788,-38,41.692.800,Neutral,0.0
10/12/2018,3713,3763,3675,3688,25,41.105.200,Negative,-0.1779
11/12/2018,3725,3738,3700,3725,0,55.657.400,Neutral,0.0
12/12/2018,3738,3775,3713,3738,0,80.631.400,Positive,"0,7464"
13/12/2018,3850,3850,3725,3750,100,92.920.000,Positive,0.6369
14/12/2018,3788,3825,3763,3825,-37,68.756.400,Neutral,0.0
17/12/2018,3700,3788,3700,3725,-25,78.685.000,Neutral,0.0
18/12/2018,3675,3675,3625,3625,50,98.608.800,Neutral,0.0
19/12/2018,3713,3738,3675,3675,38,89.550.000,Neutral,0.0
20/12/2018,3650,3713,3638,3713,-63,61.216.000,Neutral,0.0
21/12/2018,3613,3650,3588,3625,-12,98.207.400,Negative,"-0,1852"
24/12/2018,3613,3613,3613,3613,0,0,Neutral,0.0
25/12/2018,3613,3613,3613,3613,0,0,Positive,"0,1686"
26/12/2018,3613,3625,3550,3575,38,52.356.800,Positive,0.7964
27/12/2018,3638,3675,3625,3663,-25,48.514.400,Negative,"-0,25"
28/12/2018,3688,3725,3663,3675,13,97.081.600,Neutral,0.0
31/12/2018,3688,3688,3688,3688,0,0,Positive,"0,1491"
01/01/2019,3688,3688,3688,3688,0,0,Positive,"0,5311"
02/01/2019,3663,3700,3625,3700,-37,45.319.200,Neutral,0.0
03/01/2019,3588,3675,3550,3638,-50,74.174.000,Positive,0.5423
04/01/2019,3725,3725,3575,3588,137,78.514.000,Neutral,0.0
07/01/2019,3713,3788,3713,3750,-37,53.624.800,Negative,"-0,4322"
08/01/2019,3675,3738,3675,3713,-38,80.073.200,Negative,"-0,4298"
09/01/2019,3788,3788,3700,3750,38,104.903.400,Positive,"0,5079"
10/01/2019,3850,3850,3775,3813,37,130.603.200,Positive,"0,999"
11/01/2019,3850,3900,3838,3875,-25,88.899.400,Negative,"-0,1642"
14/01/2019,3850,3875,3825,3875,-25,71.320.000,Negative,"-0,3341"
15/01/2019,3900,3900,3825,3875,25,86.697.200,Positive,"0,9273"
16/01/2019,3900,3913,3838,3900,0,78.625.600,Positive,"0,1552"
17/01/2019,3938,4025,3900,3900,38,101.961.200,Positive,"0,4742"
18/01/2019,3938,3963,3913,3950,-12,56.790.000,Negative,"-0,2743"
21/01/2019,3900,3950,3900,3913,-13,111.624.400,Neutral,0.0
22/01/2019,3875,3900,3825,3863,12,123.558.000,Negative,-0.2732
23/01/2019,3738,3850,3738,3788,-50,162.196.000,Negative,-0.3818
24/01/2019,3738,3750,3713,3738,0,179.821.400,Neutral,0.0
25/01/2019,3688,3763,3650,3738,-50,143.184.800,Neutral,0.0
28/01/2019,3588,3713,3538,3688,-100,207.013.400,Neutral,0.0
29/01/2019,3563,3625,3525,3588,-25,162.587.800,Neutral,0.0
30/01/2019,3625,3663,3563,3563,62,175.565.200,Positive,"0,6546"
31/01/2019,3725,3738,3638,3663,62,214.008.600,Positive,"0,0951"
01/02/2019,3800,3813,3738,3750,50,104.295.400,Positive,0.5267
04/02/2019,3675,3800,3675,3750,-75,80.919.200,Positive,0.3818
05/02/2019,3675,3675,3675,3675,0,0,Positive,0.2023
06/02/2019,3738,3763,3713,3725,13,60.281.400,Neutral,0.0
07/02/2019,3775,3775,3713,3738,37,31.622.800,Neutral,0.0
08/02/2019,3788,3788,3713,3750,38,46.828.400,Neutral,0.0
11/02/2019,3813,3813,3763,3800,13,72.358.200,Positive,0.5267
12/02/2019,3713,3838,3688,3838,-125,82.644.200,Negative,-0.2732
13/02/2019,3625,3738,3625,3713,-88,75.046.400,Negative,-0.3818
14/02/2019,3588,3688,3588,3675,-87,95.699.000,Negative,"-0,3764"
15/02/2019,3588,3613,3550,3575,13,92.002.800,Neutral,0.0
18/02/2019,3638,3650,3588,3650,-12,86.216.800,Negative,"-0,1072"
19/02/2019,3600,3663,3563,3638,-38,92.714.200,Neutral,0.0
20/02/2019,3550,3625,3475,3625,-75,192.881.200,Positive,0.296
21/02/2019,3663,3663,3550,3563,100,100.203.800,Neutral,0.0
22/02/2019,3550,3650,3525,3638,-88,167.596.800,Neutral,0.0
25/02/2019,3625,3625,3563,3575,50,91.520.000,Positive,"0,8525"
26/02/2019,3638,3638,3575,3638,0,94.091.000,Positive,"0,8776"
27/02/2019,3600,3638,3575,3600,0,72.356.800,Positive,"0,9104"
28/02/2019,3563,3625,3550,3613,-50,84.980.200,Negative,"-0,179"
01/03/2019,3588,3613,3563,3575,13,47.003.200,Positive,"0,8576"
04/03/2019,3550,3588,3550,3588,-38,29.659.800,Negative,"-0,3591"
05/03/2019,3475,3563,3400,3525,-50,223.113.200,Neutral,0.0
06/03/2019,3538,3538,3438,3500,38,94.977.600,Positive,0.3612
07/03/2019,3538,3538,3538,3538,0,0,Neutral,0.0
08/03/2019,3450,3525,3450,3525,-75,71.523.400,Negative,"-0,3616"
11/03/2019,3425,3475,3413,3475,-50,53.912.400,Negative,-0.1779
12/03/2019,3363,3438,3338,3413,-50,60.509.600,Neutral,0.0
13/03/2019,3350,3400,3325,3400,-50,55.730.600,Neutral,0.0
14/03/2019,3450,3463,3363,3400,50,44.212.200,Neutral,0.0
15/03/2019,3550,3550,3463,3463,87,71.744.400,Positive,0.5267
18/03/2019,3550,3613,3513,3575,-25,52.140.200,Negative,"-0,2573"
19/03/2019,3688,3700,3575,3588,100,158.696.000,Positive,"0,4443"
20/03/2019,3700,3725,3650,3700,0,51.652.800,Positive,"0,374"
21/03/2019,3738,3763,3725,3750,-12,68.829.800,Positive,0.34
22/03/2019,3725,3750,3713,3738,-13,45.259.400,Neutral,0.0
25/03/2019,3588,3663,3588,3625,-37,45.751.600,Neutral,0.0
26/03/2019,3650,3675,3638,3638,12,28.799.400,Neutral,0.0
27/03/2019,3613,3713,3613,3713,-100,38.906.600,Neutral,0.0
28/03/2019,3688,3688,3625,3650,38,47.868.600,Neutral,0.0
29/03/2019,3738,3750,3663,3700,38,71.140.200,Neutral,0.0
01/04/2019,3750,3763,3725,3750,0,57.890.600,Neutral,0.0
02/04/2019,3713,3763,3663,3763,-50,36.872.800,Neutral,0.0
03/04/2019,3713,3713,3713,3713,0,0,Neutral,0.0
04/04/2019,3838,3850,3750,3750,88,119.083.400,Positive,0.1779
05/04/2019,3775,3838,3775,3838,-63,40.534.200,Negative,-0.296
08/04/2019,3750,3800,3688,3800,-50,45.862.600,Negative,"-0,1401"
09/04/2019,3838,3863,3775,3788,50,61.437.800,Positive,"0,7257"
10/04/2019,3775,3838,3763,3825,-50,30.552.600,Negative,"-0,4216"
11/04/2019,3700,3800,3700,3788,-88,70.389.000,Negative,"-0,4652"
12/04/2019,3663,3700,3650,3675,-12,53.372.400,Neutral,0.0
15/04/2019,3675,3725,3663,3700,-25,48.251.000,Neutral,0.0
16/04/2019,3813,3813,3675,3688,125,143.066.800,Neutral,0.0
17/04/2019,3813,3813,3813,3813,0,0,Neutral,0.0
18/04/2019,3900,4063,3888,3900,0,243.343.400,Positive,0.5267
19/04/2019,3900,3900,3900,3900,0,0,Positive,"0,954"
22/04/2019,3875,3938,3825,3900,-25,69.981.800,Negative,"-0,3529"
23/04/2019,3838,3888,3838,3850,-12,65.384.600,Negative,"-0,3341"
24/04/2019,3838,3863,3813,3850,-12,55.408.400,Negative,"-0,3879"
25/04/2019,3825,3838,3775,3825,0,111.185.200,Positive,"0,4222"
26/04/2019,3863,3900,3738,3775,88,150.697.400,Positive,"0,8001"
29/04/2019,3888,3900,3838,3850,38,112.773.000,Neutral,0.0
30/04/2019,3863,3938,3863,3913,-50,103.243.000,Positive,0.2023
01/05/2019,3863,3863,3863,3863,0,0,Positive,"0,727"
02/05/2019,3850,3863,3813,3850,0,68.943.800,Neutral,0.0
03/05/2019,3825,3850,3788,3850,-25,60.141.600,Positive,0.3818
06/05/2019,3763,3788,3663,3750,13,100.956.600,Positive,"0,5661"
07/05/2019,3825,3838,3775,3838,-13,68.861.800,Negative,"-0,1015"
08/05/2019,3763,3788,3725,3750,13,79.916.800,Positive,"0,9014"
09/05/2019,3750,3788,3725,3725,25,90.947.000,Positive,"0,3462"
10/05/2019,3738,3788,3688,3775,-37,65.009.400,Negative,"-0,4737"
13/05/2019,3763,3825,3750,3788,-25,83.342.800,Neutral,0.0
14/05/2019,3725,3763,3700,3725,0,85.983.800,Neutral,0.0
15/05/2019,3713,3800,3713,3763,-50,112.972.400,Neutral,0.0
16/05/2019,3675,3725,3625,3675,0,86.481.000,Positive,0.0516
17/05/2019,3538,3750,3538,3750,-212,59.716.600,Negative,"-0,3704"
20/05/2019,3613,3638,3488,3500,113,93.447.200,Positive,"0,3544"
21/05/2019,3625,3675,3538,3638,-13,128.877.200,Negative,"-0,4887"
22/05/2019,3650,3700,3613,3663,-13,88.253.000,Negative,"-0,4378"
23/05/2019,3788,3800,3663,3675,113,65.668.800,Positive,"0,2332"
24/05/2019,3850,3888,3788,3800,50,99.151.200,Positive,"0,2566"
27/05/2019,3863,3863,3763,3800,63,144.611.000,Neutral,0.0
28/05/2019,3688,3850,3675,3850,-162,298.780.800,Negative,-0.2023
29/05/2019,3775,3775,3700,3725,50,89.397.400,Neutral,0.0
30/05/2019,3775,3775,3775,3775,0,0,Positive,"0,1578"
31/05/2019,3838,3888,3775,3800,38,173.453.000,Positive,"0,4662"
03/06/2019,3838,3838,3838,3838,0,0,Positive,"0,0423"
04/06/2019,3838,3838,3838,3838,0,0,Positive,"0,7863"
05/06/2019,3838,3838,3838,3838,0,0,Positive,"0,2644"
06/06/2019,3838,3838,3838,3838,0,0,Positive,"0,9258"
07/06/2019,3838,3838,3838,3838,0,0,Positive,"0,3819"
10/06/2019,3925,3975,3913,3925,0,208.042.400,Negative,-0.1779
11/06/2019,3938,3950,3900,3938,0,107.140.400,Neutral,0.0
12/06/2019,3938,3950,3900,3950,-12,69.330.800,Neutral,0.0
13/06/2019,3913,3950,3850,3938,-25,63.482.400,Neutral,0.0
14/06/2019,3913,3938,3900,3938,-25,61.672.200,Negative,"-0,3555"
17/06/2019,3900,3950,3900,3950,-50,47.269.400,Neutral,0.0
18/06/2019,3925,3938,3888,3888,37,104.106.200,Positive,0.7351
19/06/2019,3988,4000,3938,3950,38,156.615.200,Neutral,0.0
20/06/2019,3975,4025,3963,4000,-25,93.589.200,Neutral,0.0
21/06/2019,3988,4013,3950,4000,-12,145.919.600,Neutral,0.0
24/06/2019,3988,4013,3950,3950,38,70.252.200,Neutral,0.0
25/06/2019,3975,4013,3963,4013,-38,59.303.200,Neutral,0.0
26/06/2019,3975,4000,3925,3925,50,72.115.200,Neutral,0.0
27/06/2019,4000,4025,3988,3988,12,63.152.000,Negative,-0.6908
28/06/2019,4013,4025,3988,4013,0,61.888.000,Positive,"0,5995"
01/07/2019,4000,4038,3988,4025,-25,61.455.600,Neutral,0.0
02/07/2019,4013,4025,3988,4025,-12,64.875.600,Negative,"-0,1629"
03/07/2019,4013,4013,3975,3975,38,93.933.600,Positive,0.3818
04/07/2019,4013,4025,4000,4025,-12,31.578.600,Neutral,0.0
05/07/2019,3913,4013,3863,3963,-50,186.756.200,Negative,-0.1779
08/07/2019,3938,3938,3863,3875,63,105.905.600,Positive,"0,1862"
09/07/2019,3950,3963,3900,3913,37,88.590.800,Positive,"0,5859"
10/07/2019,3975,4000,3963,3975,0,100.964.600,Positive,"0,4365"
11/07/2019,4000,4025,3988,4013,-13,70.231.200,Negative,"-0,3872"
12/07/2019,4038,4063,4013,4025,13,73.474.000,Positive,"0,0286"
15/07/2019,4075,4088,4050,4075,0,89.444.800,Positive,0.1779
16/07/2019,4038,4063,3988,4038,0,146.626.400,Neutral,0.0
17/07/2019,3988,4025,3975,4000,-12,128.231.000,Neutral,0.0
18/07/2019,3925,3975,3913,3950,-25,142.262.000,Neutral,0.0
19/07/2019,3938,3950,3900,3900,38,104.530.000,Positive,"0,0861"
22/07/2019,3888,3913,3875,3900,-12,82.851.000,Neutral,0.0
23/07/2019,3850,3925,3850,3913,-63,74.981.800,Neutral,0.0
24/07/2019,3850,3913,3850,3850,0,65.565.800,Positive,0.1779
25/07/2019,3900,3900,3850,3863,37,77.462.000,Neutral,0.0
26/07/2019,3875,3888,3813,3825,50,62.727.400,Positive,"0,725"
29/07/2019,3900,3913,3838,3913,-13,55.206.400,Positive,0.296
30/07/2019,3975,3988,3863,3900,75,87.075.600,Positive,0.1779
31/07/2019,3988,3988,3900,3938,50,59.008.800,Positive,0.3818
01/08/2019,3888,3950,3863,3938,-50,96.731.000,Neutral,0.0
02/08/2019,3838,3875,3800,3850,-12,103.727.000,Neutral,0.0
05/08/2019,3713,3825,3663,3800,-87,129.862.600,Negative,-0.1779
06/08/2019,3625,3700,3550,3650,-25,157.132.400,Negative,"-0,1451"
07/08/2019,3675,3700,3638,3638,37,103.932.800,Positive,"0,8212"
08/08/2019,3750,3763,3675,3725,25,85.711.800,Neutral,0.0
09/08/2019,3725,3775,3725,3750,-25,39.017.600,Neutral,0.0
12/08/2019,3700,3750,3675,3750,-50,69.256.600,Negative,"-0,1271"
13/08/2019,3675,3775,3650,3775,-100,68.067.800,Positive,0.4019
14/08/2019,3750,3763,3675,3750,0,107.613.000,Neutral,0.0
15/08/2019,3700,3700,3650,3675,25,57.456.400,Neutral,0.0
16/08/2019,3688,3713,3663,3700,-12,47.693.000,Negative,"-0,3571"
19/08/2019,3675,3725,3663,3725,-50,38.551.200,Neutral,0.0
20/08/2019,3688,3725,3650,3713,-25,75.396.200,Negative,"-0,1623"
21/08/2019,3613,3675,3613,3663,-50,49.841.400,Neutral,0.0
22/08/2019,3613,3663,3575,3650,-37,77.652.800,Negative,"-0,1345"
23/08/2019,3588,3625,3575,3625,-37,44.535.800,Negative,"-0,1235"
26/08/2019,3525,3550,3500,3550,-25,78.614.600,Negative,"-0,2706"
27/08/2019,3513,3563,3513,3525,-12,153.201.600,Negative,"-0,2741"
28/08/2019,3525,3550,3475,3513,12,96.082.400,Positive,"0,2412"
29/08/2019,3538,3550,3513,3525,13,63.748.800,Positive,0.2263
30/08/2019,3625,3625,3538,3563,62,106.370.600,Neutral,0.0
02/09/2019,3588,3613,3563,3613,-25,37.622.200,Positive,0.2263
03/09/2019,3450,3600,3413,3588,-138,96.998.200,Neutral,0.0
04/09/2019,3463,3488,3425,3488,-25,74.434.600,Neutral,0.0
05/09/2019,3488,3513,3463,3500,-12,78.642.800,Positive,0.2732
06/09/2019,3525,3575,3488,3513,12,88.646.000,Neutral,0.0
09/09/2019,3488,3538,3463,3538,-50,55.841.400,Neutral,0.0
10/09/2019,3525,3525,3450,3450,75,52.070.400,Neutral,0.0
11/09/2019,3575,3575,3475,3500,75,80.777.800,Positive,"0,959"
12/09/2019,3575,3663,3550,3625,-50,84.564.600,Negative,"-0,435"
13/09/2019,3600,3625,3563,3613,-13,28.700.200,Negative,"-0,1692"
16/09/2019,3500,3550,3463,3525,-25,66.615.800,Negative,"-0,3878"
17/09/2019,3488,3550,3463,3463,25,70.992.200,Positive,"0,4983"
18/09/2019,3600,3600,3525,3538,62,53.708.400,Neutral,0.0
19/09/2019,3550,3588,3538,3588,-38,35.941.600,Neutral,0.0
20/09/2019,3538,3575,3488,3550,-12,104.743.400,Neutral,0.0
23/09/2019,3500,3550,3475,3525,-25,49.012.600,Negative,"-0,2685"
24/09/2019,3475,3488,3425,3463,12,52.110.000,Positive,"0,7363"
25/09/2019,3450,3500,3438,3488,-38,37.565.400,Negative,"-0,3968"
26/09/2019,3550,3550,3475,3500,50,45.471.400,Positive,"0,57"
27/09/2019,3488,3525,3475,3500,-12,44.329.400,Negative,"-0,1255"
30/09/2019,3488,3488,3450,3450,38,58.294.000,Positive,"0,1129"
01/10/2019,3450,3525,3450,3450,0,31.243.400,Positive,"0,3038"
02/10/2019,3263,3475,3250,3438,-175,129.586.200,Negative,"-0,1675"
03/10/2019,3200,3263,3138,3263,-63,146.789.000,Negative,"-0,2417"
04/10/2019,3200,3263,3163,3225,-25,69.121.800,Negative,"-0,1603"
07/10/2019,3175,3238,3163,3238,-63,36.656.400,Negative,"-0,3999"
08/10/2019,3250,3250,3175,3175,75,104.992.000,Neutral,0.0
09/10/2019,3213,3238,3200,3225,-12,55.131.400,Neutral,0.0
10/10/2019,3263,3300,3213,3213,50,120.255.400,Neutral,0.0
11/10/2019,3275,3325,3238,3250,25,96.816.400,Neutral,0.0
14/10/2019,3300,3338,3250,3313,-13,65.272.800,Negative,"-0,1276"
15/10/2019,3288,3300,3250,3275,13,94.139.600,Positive,"0,2391"
16/10/2019,3313,3325,3275,3300,13,118.973.800,Positive,"0,1937"
17/10/2019,3350,3350,3313,3313,37,150.037.800,Positive,"0,7213"
18/10/2019,3388,3438,3325,3338,50,117.544.400,Positive,"0,4521"
21/10/2019,3400,3413,3350,3400,0,83.622.800,Positive,"0,2655"
22/10/2019,3413,3425,3375,3425,-12,62.050.200,Negative,"-0,3387"
23/10/2019,3538,3550,3375,3413,125,98.440.400,Positive,"0,4053"
24/10/2019,3613,3625,3538,3563,50,132.797.200,Neutral,0.0
25/10/2019,3500,3638,3488,3638,-138,105.735.200,Neutral,0.0
28/10/2019,3500,3538,3463,3500,0,46.389.600,Positive,"0,8869"
29/10/2019,3550,3575,3500,3550,0,91.735.400,Neutral,0.0
30/10/2019,3513,3538,3488,3538,-25,47.667.200,Positive,0.25
31/10/2019,3513,3525,3450,3525,-12,78.160.000,Neutral,0.0
01/11/2019,3488,3513,3463,3513,-25,24.366.800,Negative,-0.1779
04/11/2019,3438,3513,3438,3500,-62,56.584.800,Negative,"-0,1606"
05/11/2019,3600,3600,3463,3475,125,94.253.000,Positive,"0,4565"
06/11/2019,3488,3600,3413,3588,-100,113.175.200,Negative,"-0,4866"
07/11/2019,3500,3513,3388,3513,-13,78.753.600,Negative,"-0,1978"
08/11/2019,3550,3575,3425,3488,62,76.355.000,Positive,"0,7579"
11/11/2019,3525,3550,3488,3538,-13,45.212.000,Neutral,0.0
12/11/2019,3513,3550,3463,3500,13,52.900.800,Neutral,0.0
13/11/2019,3438,3500,3388,3500,-62,75.148.400,Neutral,0.0
14/11/2019,3438,3450,3350,3438,0,66.698.600,Neutral,0.0
15/11/2019,3475,3513,3463,3463,12,47.017.200,Positive,0.1779
18/11/2019,3488,3513,3438,3475,13,61.287.000,Positive,"0,8883"
19/11/2019,3575,3575,3475,3513,62,67.006.200,Positive,"0,7867"
20/11/2019,3550,3600,3525,3575,-25,46.727.600,Negative,"-0,4048"
21/11/2019,3588,3600,3475,3500,88,60.944.600,Neutral,0.0
22/11/2019,3538,3588,3525,3550,-12,40.452.800,Positive,0.2023
25/11/2019,3488,3525,3463,3500,-12,47.676.200,Neutral,0.0
26/11/2019,3463,3525,3450,3500,-37,173.533.200,Neutral,0.0
27/11/2019,3450,3488,3400,3413,37,72.928.800,Neutral,0.0
28/11/2019,3388,3450,3388,3425,-37,56.275.200,Neutral,0.0
29/11/2019,3488,3500,3388,3388,100,53.250.600,Neutral,0.0
02/12/2019,3550,3575,3463,3488,62,74.561.000,Positive,"0,3582"
03/12/2019,3588,3588,3513,3525,63,79.039.000,Positive,"0,1537"
04/12/2019,3538,3575,3525,3538,0,65.802.200,Positive,"0,4759"
05/12/2019,3588,3600,3538,3550,38,74.217.800,Positive,"0,2337"
06/12/2019,3588,3613,3563,3600,-12,53.720.600,Negative,"-0,4122"
09/12/2019,3625,3650,3600,3600,25,72.098.600,Neutral,0.0
10/12/2019,3688,3700,3600,3600,88,132.230.000,Neutral,0.0
11/12/2019,3675,3700,3663,3675,0,68.454.200,Neutral,0.0
12/12/2019,3650,3725,3638,3663,-13,79.738.600,Neutral,0.0
13/12/2019,3688,3725,3675,3700,-12,127.472.400,Neutral,0.0
16/12/2019,3675,3713,3675,3675,0,96.037.400,Neutral,0.0
17/12/2019,3675,3700,3663,3675,0,100.790.000,Negative,-0.0772
18/12/2019,3763,3775,3663,3675,88,123.281.600,Positive,0.2263
19/12/2019,3800,3800,3738,3763,37,112.903.200,Neutral,0.0
20/12/2019,3850,3850,3775,3775,75,150.472.200,Positive,"0,5861"
23/12/2019,3863,3900,3838,3900,-37,131.246.800,Negative,"-0,334"
26/12/2019,3900,3913,3875,3888,12,140.936.400,Positive,"0,4623"
27/12/2019,3875,3913,3863,3913,-38,58.182.800,Negative,"-0,2632"
30/12/2019,3838,3900,3825,3863,-25,78.005.800,Negative,"-0,4422"
02/01/2020,3875,3888,3825,3838,37,37.379.800,Positive,"0,8428"
03/01/2020,3863,3913,3813,3875,-12,70.294.600,Negative,"-0,2484"
06/01/2020,3800,3838,3763,3825,-25,61.892.000,Negative,"-0,2203"
07/01/2020,3800,3863,3788,3863,-63,70.895.600,Negative,"-0,236"
08/01/2020,3750,3775,3688,3775,-25,105.080.600,Negative,"-0,3497"
09/01/2020,3850,3863,3763,3775,75,75.587.000,Positive,"0,7555"
10/01/2020,3863,3863,3825,3850,13,64.231.800,Positive,"0,4281"
13/01/2020,3863,3875,3825,3863,0,75.399.600,Positive,"0,7033"
14/01/2020,3875,3900,3850,3900,-25,104.134.400,Negative,"-0,2013"
15/01/2020,3825,3900,3800,3875,-50,89.795.200,Negative,"-0,2595"
16/01/2020,3775,3838,3763,3800,-25,145.432.200,Neutral,0.0
17/01/2020,3863,3875,3763,3788,75,130.500.200,Positive,"0,9104"
20/01/2020,3813,3900,3800,3900,-87,24.031.800,Neutral,0.0
21/01/2020,3850,3875,3813,3875,-25,39.166.600,Neutral,0.0
22/01/2020,3900,3925,3863,3875,25,122.175.200,Neutral,0.0
23/01/2020,3888,3913,3850,3900,-12,83.127.800,Neutral,0.0
24/01/2020,3963,4000,3863,3913,50,154.702.000,Neutral,0.0
27/01/2020,3863,3988,3850,3975,-112,98.280.000,Negative,"-0,2728"
28/01/2020,3875,3913,3800,3825,50,69.349.600,Positive,"0,8157"
29/01/2020,3900,3963,3888,3913,-13,109.661.000,Negative,"-0,18"
30/01/2020,3825,3913,3800,3900,-75,85.395.600,Negative,"-0,1448"
31/01/2020,3775,3850,3725,3838,-63,157.661.000,Neutral,0.0
03/02/2020,3750,3788,3675,3700,50,87.271.800,Neutral,0.0
04/02/2020,3763,3838,3750,3800,-37,138.857.400,Positive,0.7506
05/02/2020,3850,3850,3775,3800,50,130.211.200,Neutral,0.0
06/02/2020,3850,3925,3838,3900,-50,111.029.400,Negative,"-0,4148"
07/02/2020,3863,3875,3838,3838,25,86.438.600,Positive,"0,6679"
10/02/2020,3863,3875,3800,3850,13,78.553.800,Positive,"0,1824"
11/02/2020,3888,3913,3838,3863,25,98.520.200,Neutral,0.0
12/02/2020,3900,3950,3888,3913,-13,104.678.800,Neutral,0.0
13/02/2020,3925,3975,3900,3913,12,87.904.000,Neutral,0.0
14/02/2020,3913,3925,3875,3875,38,41.345.200,Neutral,0.0
17/02/2020,3925,3938,3900,3925,0,29.816.600,Positive,"0,2865"
18/02/2020,3913,3925,3900,3900,13,65.442.000,Positive,"0,0625"
19/02/2020,3975,3975,3900,3925,50,121.614.200,Positive,"0,6139"
20/02/2020,4000,4025,3963,4013,-13,114.537.600,Neutral,0.0
21/02/2020,3950,4000,3913,3975,-25,91.798.000,Neutral,0.0
24/02/2020,3888,3913,3825,3900,-12,128.768.800,Positive,0.296
25/02/2020,3900,3950,3850,3888,12,105.951.800,Neutral,0.0
26/02/2020,3825,3875,3825,3875,-50,198.171.000,Negative,"-0,3298"
27/02/2020,3675,3850,3625,3825,-150,223.088.600,Negative,"-0,1657"
28/02/2020,3638,3638,3275,3375,263,188.868.200,Neutral,0.0
02/03/2020,3475,3625,3475,3575,-100,101.550.200,Negative,"-0,2808"
03/03/2020,3600,3675,3513,3550,50,96.445.200,Positive,"0,4479"
04/03/2020,3738,3750,3613,3625,113,92.555.400,Positive,"0,2649"
05/03/2020,3800,3825,3750,3775,25,104.748.600,Positive,"0,5814"
06/03/2020,3625,3700,3613,3700,-75,72.311.200,Negative,"-0,2212"
09/03/2020,3288,3500,3288,3500,-212,113.132.400,Neutral,0.0
10/03/2020,3438,3500,3325,3325,113,114.052.000,Positive,0.1779
11/03/2020,3413,3525,3313,3463,-50,97.168.800,Neutral,0.0
12/03/2020,3213,3338,3113,3238,-25,91.578.200,Neutral,0.0
13/03/2020,3175,3238,3000,3100,75,238.623.800,Positive,"0,4587"
16/03/2020,3175,3175,3175,3175,0,0,Neutral,0.0
17/03/2020,2763,2963,2763,2963,-200,186.380.400,Negative,-0.2023
18/03/2020,2575,2825,2575,2800,-225,215.103.400,Negative,"-0,4048"
19/03/2020,2395,2500,2395,2500,-105,167.876.200,Neutral,0.0
20/03/2020,2230,2370,2230,2370,-140,478.236.600,Negative,-0.3818
23/03/2020,2075,2175,2075,2175,-100,59.985.800,Negative,-0.6249
24/03/2020,1930,2115,1930,2075,-145,237.296.200,Negative,"-0,1063"
26/03/2020,2235,2290,1890,1900,335,386.557.200,Neutral,0.0
27/03/2020,2470,2613,2250,2255,215,396.812.000,Neutral,0.0
30/03/2020,2300,2420,2300,2420,-120,39.766.600,Neutral,0.0
31/03/2020,2340,2410,2225,2325,15,208.047.600,Neutral,0.0
01/04/2020,2305,2440,2220,2325,-20,152.367.000,Neutral,0.0
02/04/2020,2375,2375,2180,2285,90,132.225.200,Neutral,0.0
03/04/2020,2513,2513,2400,2400,113,105.225.600,Positive,"0,1783"
06/04/2020,2600,2613,2450,2513,87,113.980.400,Neutral,0.0
07/04/2020,2563,2800,2485,2700,-137,191.464.600,Positive,0.5267
08/04/2020,2385,2588,2385,2588,-203,155.834.800,Neutral,0.0
09/04/2020,2335,2450,2305,2400,-65,163.570.800,Neutral,0.0
13/04/2020,2235,2340,2235,2340,-105,115.331.000,Positive,0.1531
14/04/2020,2285,2320,2200,2240,45,132.848.000,Neutral,0.0
15/04/2020,2200,2345,2200,2320,-120,124.661.000,Neutral,0.0
16/04/2020,2105,2200,2075,2200,-95,215.224.000,Positive,0.1531
17/04/2020,2190,2210,2110,2110,80,163.407.600,Positive,"0,0128"
20/04/2020,2185,2265,2135,2225,-40,120.672.000,Neutral,0.0
21/04/2020,2175,2205,2125,2185,-10,92.203.200,Negative,-0.1779
22/04/2020,2245,2250,2125,2165,80,126.786.800,Neutral,0.0
23/04/2020,2250,2285,2240,2245,5,115.336.400,Neutral,0.0
24/04/2020,2140,2250,2140,2250,-110,131.631.400,Neutral,0.0
27/04/2020,2075,2175,2045,2155,-80,205.382.600,Negative,"-0,1051"
28/04/2020,2075,2120,2035,2095,-20,157.370.600,Neutral,0.0
29/04/2020,2000,2110,2000,2100,-100,192.650.200,Neutral,0.0
30/04/2020,2230,2240,2030,2035,195,229.509.600,Neutral,0.0
04/05/2020,2145,2230,2120,2230,-85,80.572.600,Neutral,0.0
05/05/2020,2110,2200,2080,2150,-40,185.282.400,Neutral,0.0
06/05/2020,2080,2130,2080,2125,-45,138.733.000,Positive,0.1779
08/05/2020,2100,2155,2090,2100,0,127.482.200,Negative,-0.1779
11/05/2020,2115,2140,2095,2140,-25,83.552.200,Neutral,0.0
12/05/2020,2005,2115,2000,2115,-110,188.578.000,Neutral,0.0
13/05/2020,2005,2025,1950,1995,10,134.821.600,Negative,-0.2023
14/05/2020,1975,2005,1950,1985,-10,141.388.800,Negative,"-0,3423"
15/05/2020,1880,1995,1840,1975,-95,227.234.200,Negative,"-0,2887"
18/05/2020,1860,1900,1830,1900,-40,158.710.600,Neutral,0.0
19/05/2020,1930,2000,1880,1880,50,199.655.000,Neutral,0.0
20/05/2020,2035,2060,1915,1925,110,237.644.400,Positive,0.1779
26/05/2020,2050,2080,2030,2065,-15,180.545.000,Positive,0.5574
27/05/2020,2055,2100,2005,2075,-20,124.329.600,Neutral,0.0
28/05/2020,2145,2170,2075,2075,70,265.460.200,Positive,0.34
29/05/2020,2235,2245,2125,2145,90,350.546.800,Positive,"0,9453"
02/06/2020,2310,2495,2265,2275,35,207.635.400,Negative,-0.1531
03/06/2020,2430,2475,2295,2335,95,296.607.800,Positive,"0,4498"
04/06/2020,2365,2500,2360,2450,-85,169.836.200,Positive,0.5106
05/06/2020,2425,2435,2300,2365,60,185.391.000,Positive,"0,8411"
08/06/2020,2625,2663,2475,2500,125,292.605.200,Neutral,0.0
09/06/2020,2638,2725,2575,2650,-12,147.413.600,Neutral,0.0
10/06/2020,2455,2613,2455,2600,-145,289.644.200,Negative,"-0,4288"
11/06/2020,2345,2435,2285,2400,-55,364.783.800,Negative,-0.1779
12/06/2020,2445,2450,2215,2295,150,289.959.400,Neutral,0.0
15/06/2020,2360,2455,2345,2425,-65,169.814.600,Neutral,0.0
16/06/2020,2513,2525,2410,2410,103,146.116.600,Neutral,0.0
17/06/2020,2450,2600,2445,2550,-100,213.944.600,Negative,"-0,1469"
18/06/2020,2410,2485,2390,2420,-10,152.175.200,Negative,"-0,1161"
19/06/2020,2440,2475,2410,2440,0,126.356.800,Neutral,0.0
22/06/2020,2405,2455,2400,2440,-35,66.825.000,Neutral,0.0
23/06/2020,2395,2425,2345,2425,-30,95.010.400,Positive,0.2732
24/06/2020,2575,2600,2445,2445,130,278.417.000,Neutral,0.0
25/06/2020,2513,2600,2470,2538,-25,146.123.000,Positive,0.1531
26/06/2020,2500,2575,2490,2563,-63,85.829.000,Neutral,0.0
29/06/2020,2470,2500,2435,2490,-20,99.123.000,Neutral,0.0
30/06/2020,2475,2525,2475,2513,-38,113.994.400,Negative,-0.34
01/07/2020,2495,2513,2455,2500,-5,67.747.600,Neutral,0.0
02/07/2020,2500,2513,2480,2490,10,80.606.600,Positive,"0,1971"
03/07/2020,2500,2538,2450,2480,20,57.839.800,Positive,"0,704"
06/07/2020,2538,2575,2500,2500,38,90.019.000,Neutral,0.0
07/07/2020,2525,2575,2525,2563,-38,80.447.600,Positive,0.6705
08/07/2020,2638,2675,2513,2525,113,149.466.800,Negative,-0.3818
09/07/2020,2625,2700,2600,2675,-50,98.277.200,Negative,-0.0772
10/07/2020,2588,2638,2563,2625,-37,77.850.000,Neutral,0.0
13/07/2020,2625,2663,2613,2625,0,72.688.200,Neutral,0.0
14/07/2020,2650,2663,2600,2650,0,78.259.800,Positive,0.6486
15/07/2020,2638,2713,2625,2675,-37,60.755.400,Neutral,0.0
16/07/2020,2638,2675,2625,2638,0,43.859.400,Neutral,0.0
17/07/2020,2588,2650,2588,2638,-50,60.177.000,Neutral,0.0
20/07/2020,2550,2613,2525,2588,-38,52.111.600,Neutral,0.0
21/07/2020,2650,2725,2538,2575,75,145.051.400,Neutral,0.0
22/07/2020,2713,2763,2650,2688,25,119.245.000,Neutral,0.0
23/07/2020,2850,2888,2713,2738,112,145.829.600,Neutral,0.0
24/07/2020,2800,2850,2775,2850,-50,66.603.400,Positive,0.5267
27/07/2020,2938,2938,2775,2813,125,58.848.200,Positive,"0,5406"
28/07/2020,2925,3000,2888,2950,-25,74.524.600,Positive,0.5574
29/07/2020,2850,2925,2838,2925,-75,69.737.200,Neutral,-0.0258
30/07/2020,2900,2900,2813,2863,37,52.644.600,Neutral,0.0
03/08/2020,2750,2938,2725,2925,-175,259.720.800,Negative,"-0,4346"
04/08/2020,2788,2800,2725,2763,25,89.173.800,Positive,"0,3599"
05/08/2020,2850,2850,2725,2775,75,133.844.600,Positive,"0,7885"
06/08/2020,2888,2938,2850,2850,38,90.911.200,Positive,"0,9303"
07/08/2020,2900,2900,2813,2850,50,57.228.800,Positive,"0,2559"
10/08/2020,2900,2913,2825,2900,0,50.162.400,Positive,"0,6664"
11/08/2020,2988,3050,2900,2913,75,117.978.200,Positive,"0,0272"
12/08/2020,3075,3138,2975,3000,75,92.910.400,Positive,"0,3929"
13/08/2020,3025,3125,3025,3125,-100,85.989.200,Negative,"-0,1185"
14/08/2020,3013,3050,2975,3038,-25,66.653.400,Negative,"-0,1607"
18/08/2020,3075,3113,3013,3013,62,115.981.200,Positive,"0,7552"
19/08/2020,3050,3125,3038,3088,-38,64.511.800,Negative,"-0,4932"
24/08/2020,3000,3088,2963,3025,-25,132.486.400,Negative,"-0,3021"
25/08/2020,3125,3138,3025,3025,100,132.365.800,Positive,"0,9348"
26/08/2020,3175,3175,3088,3125,50,78.703.400,Positive,"0,2015"
27/08/2020,3150,3175,3100,3175,-25,93.450.200,Negative,"-0,1377"
28/08/2020,3113,3175,3100,3138,-25,75.655.000,Negative,"-0,4963"
31/08/2020,2975,3150,2950,3113,-138,222.818.800,Negative,"-0,3254"
01/09/2020,3063,3063,2938,2988,75,85.330.800,Positive,"0,2654"
02/09/2020,3038,3100,3025,3063,-25,93.203.600,Negative,"-0,1124"
03/09/2020,2988,3075,2975,3038,-50,129.014.800,Negative,"-0,1371"
04/09/2020,2963,2988,2925,2975,-12,106.844.400,Negative,"-0,1738"
07/09/2020,2925,2975,2888,2963,-38,100.673.600,Negative,"-0,1339"
08/09/2020,2988,3000,2938,2950,38,60.346.000,Positive,"0,3191"
09/09/2020,2888,2950,2875,2950,-62,98.282.200,Negative,"-0,4939"
10/09/2020,2688,2763,2688,2763,-75,172.775.200,Negative,"-0,1662"
11/09/2020,2738,2763,2525,2525,213,271.155.800,Positive,"0,6733"
14/09/2020,2875,2888,2738,2738,137,143.569.800,Positive,"0,428"
15/09/2020,2838,2913,2800,2875,-37,128.927.400,Negative,"-0,3779"
16/09/2020,2825,2875,2813,2875,-50,57.936.000,Negative,"-0,3296"
17/09/2020,2788,2875,2763,2800,-12,76.432.000,Negative,"-0,1256"
18/09/2020,2788,2838,2750,2788,0,91.596.600,Positive,"0,9105"
21/09/2020,2738,2813,2700,2788,-50,52.930.000,Negative,"-0,4779"
22/09/2020,2650,2713,2638,2650,0,113.596.600,Positive,"0,6776"
23/09/2020,2600,2688,2563,2650,-50,84.710.800,Negative,"-0,3525"
24/09/2020,2538,2575,2500,2525,13,121.965.000,Positive,"0,903"
25/09/2020,2675,2675,2538,2600,75,140.455.600,Positive,"0,5384"
28/09/2020,2575,2713,2575,2700,-125,99.702.600,Negative,"-0,4858"
29/09/2020,2538,2625,2513,2600,-62,111.325.600,Negative,"-0,1362"
30/09/2020,2480,2575,2430,2550,-70,151.529.800,Negative,"-0,4437"
01/10/2020,2600,2600,2490,2500,100,78.954.200,Positive,"0,8949"
02/10/2020,2600,2613,2500,2588,12,99.143.400,Positive,"0,8388"
05/10/2020,2675,2688,2588,2625,50,74.300.800,Positive,"0,9662"
06/10/2020,2750,2775,2725,2750,0,89.104.400,Positive,"0,003"
07/10/2020,2775,2775,2688,2700,75,88.748.600,Positive,"0,6615"
08/10/2020,2725,2788,2713,2775,-50,88.763.400,Negative,"-0,1543"
09/10/2020,2775,2788,2725,2725,50,90.248.600,Positive,"0,2485"
12/10/2020,2813,2825,2775,2788,25,77.947.000,Positive,"0,9874"
13/10/2020,2838,2838,2763,2813,25,69.863.400,Positive,"0,5474"
14/10/2020,2888,2888,2813,2863,25,109.787.200,Positive,"0,6401"
15/10/2020,2800,2875,2800,2850,-50,77.289.200,Negative,"-0,3829"
16/10/2020,2788,2825,2725,2800,-12,67.817.800,Negative,"-0,376"
19/10/2020,2850,2863,2788,2800,50,58.936.200,Positive,"0,4389"
20/10/2020,2825,2875,2800,2863,-38,77.213.200,Negative,"-0,1359"
21/10/2020,2763,2863,2738,2838,-75,113.901.800,Negative,"-0,4397"
22/10/2020,2725,2775,2700,2750,-25,138.701.400,Negative,"-0,269"
23/10/2020,2775,2788,2738,2763,12,65.900.200,Positive,"0,2837"
26/10/2020,2888,2925,2813,2813,75,188.574.400,Positive,"0,7786"
27/10/2020,2888,2925,2850,2875,13,112.695.800,Positive,"0,8989"
02/11/2020,2988,3013,2800,2838,150,216.862.800,Positive,"0,7744"
03/11/2020,3000,3000,2950,2988,12,75.963.400,Positive,"0,4634"
04/11/2020,2850,3013,2850,2975,-125,152.817.400,Negative,"-0,2033"
05/11/2020,2988,3000,2913,2938,50,175.877.400,Positive,"0,5957"
06/11/2020,3025,3050,2963,2988,37,164.219.000,Positive,"0,1271"
09/11/2020,3075,3150,3025,3125,-50,122.653.200,Negative,"-0,3016"
10/11/2020,3188,3263,3150,3200,-12,249.588.800,Negative,"-0,4863"
11/11/2020,3188,3250,3175,3213,-25,166.490.200,Negative,"-0,474"
12/11/2020,3088,3200,3050,3188,-100,136.150.600,Negative,"-0,1963"
13/11/2020,3125,3125,3038,3050,75,122.043.800,Positive,"0,4282"
16/11/2020,3100,3225,3075,3150,-50,133.917.600,Negative,"-0,3202"
17/11/2020,3125,3188,3100,3138,-13,106.261.600,Negative,"-0,3335"
18/11/2020,3175,3175,3075,3075,100,124.936.000,Positive,"0,4363"
19/11/2020,3163,3175,3100,3125,38,94.808.200,Positive,"0,0742"
20/11/2020,3150,3175,3125,3138,12,100.573.600,Positive,"0,0764"
23/11/2020,3200,3213,3138,3150,50,106.905.400,Positive,"0,5247"
24/11/2020,3213,3250,3188,3225,-12,140.929.200,Negative,"-0,4544"
25/11/2020,3263,3325,3250,3250,13,197.704.000,Positive,"0,3367"
26/11/2020,3363,3363,3275,3300,63,132.275.400,Positive,"0,1986"
27/11/2020,3325,3400,3313,3388,-63,124.346.800,Negative,"-0,1832"
30/11/2020,3163,3313,3113,3275,-112,307.900.800,Negative,"-0,3207"
01/12/2020,3263,3313,3163,3163,100,176.568.000,Positive,"0,2074"
02/12/2020,3325,3325,3238,3263,62,114.721.600,Positive,"0,9347"
03/12/2020,3288,3338,3263,3325,-37,155.342.400,Negative,"-0,3482"
04/12/2020,3300,3300,3213,3250,50,74.976.000,Positive,"0,9063"
07/12/2020,3350,3375,3313,3338,12,133.585.800,Positive,"0,6847"
08/12/2020,3338,3363,3300,3338,0,70.350.400,Positive,"0,0734"
10/12/2020,3400,3425,3363,3388,12,187.847.000,Positive,"0,7661"
11/12/2020,3388,3438,3350,3425,-37,94.541.800,Negative,"-0,2508"
14/12/2020,3363,3400,3338,3363,0,94.645.200,Positive,"0,7687"
15/12/2020,3350,3363,3300,3350,0,135.663.800,Positive,"0,9509"
16/12/2020,3388,3413,3363,3400,-12,97.361.800,Negative,"-0,1297"
17/12/2020,3438,3438,3388,3388,50,109.966.000,Positive,"0,6895"
18/12/2020,3350,3413,3350,3400,-50,142.797.800,Negative,"-0,1398"
21/12/2020,3350,3400,3338,3388,-38,83.174.600,Negative,"-0,439"
22/12/2020,3200,3313,3175,3288,-88,165.929.800,Negative,"-0,2494"
23/12/2020,3175,3300,3100,3250,-75,110.032.400,Negative,"-0,4473"
28/12/2020,3263,3288,3150,3250,13,75.527.000,Positive,"0,6942"
29/12/2020,3213,3300,3200,3288,-75,57.422.600,Negative,"-0,3887"
30/12/2020,3163,3263,3163,3263,-100,88.941.400,Negative,"-0,3524"
04/01/2021,3250,3263,3113,3175,75,61.058.000,Positive,"0,4367"
05/01/2021,3213,3275,3200,3275,-62,69.928.200,Negative,"-0,2685"
06/01/2021,3213,3263,3138,3213,0,87.109.000,Positive,"0,0111"
07/01/2021,3238,3263,3213,3225,13,80.114.200,Positive,"0,2558"
08/01/2021,3275,3288,3225,3238,37,93.635.600,Positive,"0,1245"
11/01/2021,3425,3425,3275,3288,137,212.763.000,Positive,"0,0166"
12/01/2021,3475,3500,3413,3450,25,168.626.000,Positive,"0,2446"
13/01/2021,3463,3538,3463,3525,-62,107.392.200,Negative,"-0,2421"
14/01/2021,3425,3525,3413,3525,-100,70.295.000,Negative,"-0,2925"
15/01/2021,3363,3463,3313,3438,-75,77.235.600,Negative,"-0,3838"
18/01/2021,3463,3475,3300,3300,163,119.006.800,Positive,"0,0873"
19/01/2021,3488,3513,3425,3500,-12,77.834.600,Negative,"-0,1822"
20/01/2021,3688,3725,3500,3500,188,220.934.600,Positive,"0,5765"
21/01/2021,3625,3688,3600,3688,-63,82.052.000,Negative,"-0,3146"
22/01/2021,3600,3675,3563,3638,-38,117.367.200,Negative,"-0,4417"
25/01/2021,3650,3650,3513,3625,25,100.647.600,Positive,"0,822"
26/01/2021,3688,3725,3625,3650,38,206.712.400,Positive,"0,3558"
27/01/2021,3650,3700,3588,3700,-50,171.581.400,Negative,"-0,4963"
28/01/2021,3525,3625,3450,3575,-50,135.745.000,Negative,"-0,2575"
29/01/2021,3288,3613,3288,3550,-262,334.227.600,Negative,"-0,4145"
01/02/2021,3350,3363,3100,3325,25,242.540.200,Positive,"0,4647"
02/02/2021,3238,3400,3200,3400,-162,160.482.800,Negative,"-0,1881"
03/02/2021,3250,3325,3225,3300,-50,167.044.600,Negative,"-0,3857"
04/02/2021,3288,3338,3225,3288,0,139.040.400,Positive,"0,809"
05/02/2021,3275,3350,3225,3350,-75,97.199.600,Negative,"-0,2514"
08/02/2021,3288,3338,3275,3300,-12,125.050.800,Negative,"-0,3265"
09/02/2021,3250,3350,3225,3300,-50,208.380.400,Negative,"-0,4989"
10/02/2021,3250,3288,3238,3288,-38,102.693.600,Negative,"-0,2405"
11/02/2021,3250,3275,3250,3275,-25,35.879.400,Negative,"-0,3878"
15/02/2021,3250,3288,3250,3275,-25,48.995.200,Negative,"-0,426"
16/02/2021,3238,3275,3225,3250,-12,63.202.000,Negative,"-0,3682"
17/02/2021,3175,3238,3150,3225,-50,117.413.600,Negative,"-0,365"
18/02/2021,3125,3200,3113,3125,0,113.989.000,Positive,"0,1273"
19/02/2021,3188,3200,3100,3125,63,102.020.400,Positive,"0,7443"
22/02/2021,3188,3250,3188,3225,-37,107.680.600,Negative,"-0,4865"
23/02/2021,3163,3188,3150,3150,13,89.107.800,Positive,"0,5876"
24/02/2021,3188,3200,3163,3175,13,82.498.600,Positive,"0,1325"
25/02/2021,3138,3238,3138,3213,-75,133.614.800,Negative,"-0,2492"
26/02/2021,3075,3163,3050,3088,-13,246.190.600,Negative,"-0,3856"
01/03/2021,3288,3300,3113,3113,175,220.785.400,Positive,"0,4438"
02/03/2021,3300,3325,3250,3325,-25,163.296.600,Negative,"-0,1925"
03/03/2021,3300,3338,3263,3338,-38,78.532.200,Negative,"-0,2681"
04/03/2021,3275,3325,3263,3313,-38,120.612.600,Negative,"-0,4907"
05/03/2021,3238,3288,3225,3263,-25,87.239.000,Negative,"-0,3943"
08/03/2021,3213,3288,3188,3275,-62,54.098.000,Negative,"-0,1234"
09/03/2021,3213,3263,3188,3188,25,111.838.800,Positive,"0,7379"
10/03/2021,3250,3250,3225,3250,0,51.903.000,Positive,"0,6862"
12/03/2021,3363,3375,3275,3275,88,159.202.400,Positive,"0,9237"
15/03/2021,3325,3388,3313,3388,-63,79.922.400,Negative,"-0,4364"
16/03/2021,3275,3363,3250,3325,-50,112.248.400,Negative,"-0,3937"
17/03/2021,3263,3325,3263,3300,-37,50.841.200,Negative,"-0,129"
18/03/2021,3400,3425,3313,3313,87,152.427.600,Positive,"0,8543"
19/03/2021,3388,3400,3350,3400,-12,150.713.800,Negative,"-0,3068"
22/03/2021,3313,3413,3313,3375,-62,115.979.200,Negative,"-0,2366"
23/03/2021,3338,3375,3313,3375,-37,97.289.600,Negative,"-0,1905"
24/03/2021,3213,3263,3200,3250,-37,115.254.200,Negative,"-0,308"
25/03/2021,3200,3238,3163,3225,-25,71.666.600,Negative,"-0,1676"
26/03/2021,3213,3238,3175,3225,-12,84.478.000,Negative,"-0,2662"
29/03/2021,3188,3250,3188,3200,-12,79.520.400,Negative,"-0,4328"
30/03/2021,3163,3213,3138,3200,-37,41.180.600,Negative,"-0,3722"
31/03/2021,3075,3163,3063,3125,-50,159.155.800,Negative,"-0,3871"
01/04/2021,3100,3163,3075,3125,-25,77.715.200,Negative,"-0,4457"
05/04/2021,3113,3150,3100,3150,-37,39.468.400,Negative,"-0,1903"
06/04/2021,3138,3150,3075,3113,25,29.650.600,Positive,"0,5378"
07/04/2021,3163,3163,3125,3150,13,46.420.200,Positive,"0,1366"
08/04/2021,3138,3188,3100,3125,13,88.449.600,Positive,"0,6174"
09/04/2021,3238,3275,3163,3188,50,126.420.200,Positive,"0,4168"
12/04/2021,3150,3250,3138,3213,-63,48.429.000,Negative,"-0,1003"
13/04/2021,3150,3175,3100,3100,50,76.327.000,Positive,"0,611"
14/04/2021,3163,3200,3125,3175,-12,80.914.000,Negative,"-0,277"
15/04/2021,3150,3200,3113,3200,-50,68.337.400,Negative,"-0,2759"
16/04/2021,3150,3175,3125,3175,-25,63.194.400,Negative,"-0,1198"
19/04/2021,3113,3138,3100,3125,-12,43.598.600,Negative,"-0,4114"
20/04/2021,3100,3125,3088,3100,0,63.882.600,Positive,"0,4476"
21/04/2021,3063,3088,3063,3075,-12,65.425.600,Negative,"-0,1877"
22/04/2021,3063,3113,3050,3088,-25,71.452.000,Negative,"-0,3813"
23/04/2021,3075,3075,3013,3025,50,104.928.400,Positive,"0,0979"
26/04/2021,2988,3063,2975,3050,-62,115.305.000,Negative,"-0,1673"
27/04/2021,3025,3038,2975,2988,37,96.850.800,Positive,"0,2765"
28/04/2021,3100,3138,3050,3050,50,161.162.600,Positive,"0,0658"
29/04/2021,3113,3138,3075,3113,0,82.870.600,Positive,"0,7044"
30/04/2021,3088,3125,3063,3113,-25,69.941.600,Negative,"-0,197"
03/05/2021,3025,3075,3000,3050,-25,65.334.000,Negative,"-0,4704"
04/05/2021,3050,3050,2988,3025,25,56.355.200,Positive,"0,0591"
05/05/2021,3025,3075,3025,3075,-50,45.851.800,Negative,"-0,2212"
06/05/2021,3038,3063,3013,3063,-25,37.091.000,Negative,"-0,391"
07/05/2021,2975,3063,2975,3063,-88,65.331.800,Negative,"-0,2023"
10/05/2021,2988,3013,2975,3013,-25,35.481.400,Negative,"-0,1481"
11/05/2021,2950,3000,2925,3000,-50,69.381.800,Negative,"-0,124"
17/05/2021,2963,3000,2938,2988,-25,95.099.800,Negative,"-0,2581"
18/05/2021,2950,3000,2913,2988,-38,73.965.200,Negative,"-0,4523"
19/05/2021,2838,2925,2813,2900,-62,98.436.000,Negative,"-0,3018"
20/05/2021,2825,2875,2800,2825,0,69.610.000,Positive,"0,0263"
21/05/2021,2913,2950,2838,2863,50,140.453.000,Positive,"0,9015"
24/05/2021,2875,2938,2875,2938,-63,54.897.600,Negative,"-0,2163"
25/05/2021,2950,2975,2888,2888,62,90.594.400,Positive,"0,2454"
27/05/2021,2875,3000,2875,3000,-125,353.889.800,Negative,"-0,1022"
28/05/2021,2900,2950,2888,2913,-13,78.305.800,Negative,"-0,134"
31/05/2021,3000,3050,2913,2938,62,96.660.000,Positive,"0,2719"
02/06/2021,3050,3100,3038,3075,-25,157.335.600,Negative,"-0,2065"
03/06/2021,3125,3138,3063,3088,37,86.426.400,Positive,"0,3259"
04/06/2021,3063,3163,3063,3125,-62,76.307.800,Negative,"-0,1694"
07/06/2021,3063,3100,3038,3100,-37,42.514.400,Negative,"-0,4001"
08/06/2021,3000,3075,3000,3075,-75,57.084.000,Negative,"-0,3543"
09/06/2021,3075,3088,3000,3038,37,47.078.600,Positive,"0,7125"
10/06/2021,3100,3125,3063,3088,12,43.543.600,Positive,"0,4729"
11/06/2021,3138,3150,3113,3138,0,77.757.800,Positive,"0,6053"
14/06/2021,3138,3150,3113,3150,-12,50.043.400,Negative,"-0,3543"
15/06/2021,3163,3163,3113,3150,13,107.187.800,Positive,"0,5403"
16/06/2021,3138,3175,3100,3163,-25,90.051.600,Negative,"-0,2578"
17/06/2021,3100,3138,3100,3125,-25,146.517.200,Negative,"-0,1344"
18/06/2021,3100,3100,2975,3088,12,201.335.400,Positive,"0,029"
21/06/2021,3013,3050,2975,3050,-37,138.949.200,Negative,"-0,2986"
22/06/2021,3088,3125,3013,3038,50,96.680.600,Positive,"0,4497"
23/06/2021,3013,3113,3013,3113,-100,66.074.200,Negative,"-0,3195"
24/06/2021,2988,3050,2988,3050,-62,52.248.000,Negative,"-0,2749"
25/06/2021,2950,3013,2950,3000,-50,61.052.000,Negative,"-0,3882"
28/06/2021,2850,2950,2838,2913,-63,127.109.000,Negative,"-0,197"
29/06/2021,2888,2925,2850,2925,-37,96.970.800,Negative,"-0,3406"
30/06/2021,2950,2975,2900,2925,25,146.560.200,Positive,"0,3434"
01/07/2021,2988,3000,2950,2975,13,87.385.400,Positive,"0,7291"
02/07/2021,2975,3013,2963,2988,-13,80.422.400,Negative,"-0,1999"
05/07/2021,2925,2988,2900,2988,-63,29.242.400,Negative,"-0,4059"
06/07/2021,2888,2950,2875,2950,-62,56.066.200,Negative,"-0,2405"
07/07/2021,2875,2913,2838,2888,-13,96.691.000,Negative,"-0,2347"
08/07/2021,2950,2950,2875,2925,25,81.459.000,Positive,"0,8307"
09/07/2021,2888,2950,2888,2950,-62,50.822.400,Negative,"-0,165"
12/07/2021,2900,2938,2888,2938,-38,39.692.600,Negative,"-0,1444"
13/07/2021,2888,2950,2888,2925,-37,65.117.000,Negative,"-0,1735"
14/07/2021,2850,2913,2825,2900,-50,59.225.200,Negative,"-0,2135"
15/07/2021,2938,2950,2838,2863,75,94.438.400,Positive,"0,7989"
16/07/2021,2938,2950,2913,2938,0,39.567.600,Positive,"0,1683"
19/07/2021,2875,2925,2875,2900,-25,31.460.200,Negative,"-0,3801"
21/07/2021,2963,2975,2900,2913,50,87.100.200,Positive,"0,686"
22/07/2021,3025,3050,2975,2988,37,55.171.400,Positive,"0,019"
23/07/2021,2988,3025,2975,3000,-12,37.457.600,Negative,"-0,2745"
26/07/2021,2900,3000,2900,2988,-88,77.160.200,Neutral,0.0
27/07/2021,2913,2950,2875,2925,-12,79.279.400,Neutral,0.0
28/07/2021,2950,2950,2875,2875,75,41.266.000,Positive,0.4215
29/07/2021,2875,2950,2875,2950,-75,68.168.400,Neutral,0.0
30/07/2021,2850,2913,2850,2913,-63,92.132.400,Neutral,0.0
02/08/2021,2838,2888,2813,2888,-50,68.571.000,Negative,"-0,1361"
03/08/2021,2888,2900,2825,2850,38,70.957.400,Neutral,0.0
04/08/2021,2913,2950,2888,2913,0,67.410.400,Positive,0.1531
05/08/2021,3025,3038,2925,2938,87,140.254.000,Neutral,0.0
06/08/2021,2988,3050,2975,3038,-50,63.682.000,Neutral,0.0
09/08/2021,2900,3013,2900,3000,-100,50.317.400,Neutral,0.0
10/08/2021,2900,2938,2888,2900,0,54.893.400,Neutral,0.0
12/08/2021,2963,2975,2913,2938,25,51.328.800,Neutral,0.0
13/08/2021,3000,3025,2950,2988,12,41.771.600,Neutral,0.0
16/08/2021,2988,3025,2925,3000,-12,53.074.000,Neutral,0.0
18/08/2021,3025,3088,2963,3000,25,141.229.400,Neutral,0.0
19/08/2021,2925,3050,2900,3050,-125,101.976.800,Neutral,0.0
20/08/2021,2950,2975,2900,2950,0,62.841.600,Positive,"0,8052"
23/08/2021,2988,3000,2950,2950,38,46.346.200,Positive,0.1531
24/08/2021,2913,2988,2900,2975,-62,85.217.600,Negative,"-0,2871"
25/08/2021,2975,2988,2925,2938,37,60.726.800,Neutral,0.0
26/08/2021,2913,2963,2913,2925,-12,55.050.200,Positive,0.4404
27/08/2021,2900,2938,2888,2913,-13,35.765.000,Neutral,0.0
30/08/2021,2975,2975,2913,2925,50,65.062.000,Neutral,0.0
31/08/2021,3050,3050,2975,3000,50,135.700.400,Neutral,0.0
01/09/2021,3000,3050,3000,3050,-50,70.082.000,Positive,0.5423
02/09/2021,3025,3050,2988,3025,0,51.554.400,Neutral,0.0
03/09/2021,3063,3075,3000,3050,13,50.760.000,Positive,0.6124
06/09/2021,3100,3163,3063,3100,0,51.684.400,Neutral,0.0
07/09/2021,3125,3175,3113,3125,0,70.448.400,Positive,0.4404
08/09/2021,3125,3150,3063,3150,-25,84.660.600,Neutral,0.0
09/09/2021,3175,3175,3063,3150,25,93.331.600,Neutral,0.0
10/09/2021,3100,3150,3088,3138,-38,107.576.800,Neutral,0.0
13/09/2021,3075,3113,3025,3050,25,104.806.600,Neutral,0.0
14/09/2021,3050,3100,3038,3075,-25,84.931.400,Positive,0.1779
15/09/2021,3063,3100,3050,3088,-25,135.497.800,Neutral,0.0
16/09/2021,3075,3100,3063,3088,-13,61.344.200,Positive,0.2023
17/09/2021,3025,3075,3025,3063,-38,82.452.800,Neutral,0.0
20/09/2021,3013,3038,2963,3013,0,57.569.200,Neutral,0.0
21/09/2021,2988,3013,2963,3013,-25,45.153.400,Neutral,0.0
22/09/2021,3038,3050,2975,2988,50,26.711.200,Positive,"0,6896"
23/09/2021,3038,3063,3013,3063,-25,40.606.000,Positive,0.4215
24/09/2021,2988,3050,2963,3038,-50,50.278.400,Neutral,0.0
27/09/2021,2950,3013,2950,3000,-50,68.500.800,Positive,0.5095
28/09/2021,2975,3013,2950,2975,0,64.652.200,Neutral,0.0
29/09/2021,3000,3025,2963,2975,25,56.467.400,Positive,0.2023
30/09/2021,3075,3075,3000,3025,50,82.812.000,Negative,-0.1779
01/10/2021,3050,3100,3025,3075,-25,74.975.400,Neutral,0.0
04/10/2021,3238,3250,3075,3088,150,156.691.600,Positive,0.34
05/10/2021,3213,3275,3188,3225,-12,94.886.200,Neutral,0.0
06/10/2021,3300,3338,3225,3238,62,168.775.800,Neutral,0.0
07/10/2021,3350,3413,3313,3325,25,253.196.600,Neutral,0.0
08/10/2021,3450,3488,3363,3363,87,223.592.000,Neutral,0.0
11/10/2021,3450,3463,3400,3450,0,123.020.200,Positive,0.3818
12/10/2021,3500,3525,3463,3488,12,191.044.200,Negative,-0.6249
13/10/2021,3550,3550,3475,3538,12,134.998.000,Positive,0.2263
14/10/2021,3588,3588,3525,3563,25,104.307.800,Neutral,0.0
15/10/2021,3575,3600,3538,3588,-13,84.353.000,Neutral,0.0
18/10/2021,3588,3663,3575,3600,-12,152.951.600,Neutral,0.0
19/10/2021,3600,3625,3525,3625,-25,99.358.000,Neutral,0.0
21/10/2021,3588,3663,3563,3588,0,189.264.000,Neutral,0.0
22/10/2021,3600,3613,3538,3550,50,65.782.600,Neutral,0.0
25/10/2021,3563,3625,3563,3588,-25,76.296.200,Positive,0.4939
26/10/2021,3588,3600,3550,3550,38,55.872.800,Neutral,0.0
27/10/2021,3575,3613,3563,3600,-25,82.925.200,Neutral,0.0
28/10/2021,3513,3575,3500,3563,-50,99.023.600,Positive,0.2023
29/10/2021,3588,3650,3575,3588,0,160.952.400,Positive,0.2023
01/11/2021,3588,3625,3575,3625,-37,65.621.400,Neutral,0.0
02/11/2021,3513,3600,3500,3588,-75,51.923.400,Neutral,0.0
03/11/2021,3563,3625,3463,3488,75,107.556.600,Neutral,0.0
04/11/2021,3588,3650,3588,3625,-37,103.726.400,Neutral,0.0
05/11/2021,3550,3625,3500,3625,-75,48.035.600,Neutral,0.0
08/11/2021,3500,3600,3500,3600,-100,50.517.400,Neutral,0.0
09/11/2021,3438,3550,3425,3525,-87,120.574.200,Neutral,0.0
10/11/2021,3575,3575,3438,3438,137,156.118.000,Neutral,0.0
11/11/2021,3613,3613,3513,3563,50,86.362.400,Positive,0.4404
12/11/2021,3550,3638,3525,3638,-88,56.807.000,Neutral,0.0
15/11/2021,3525,3575,3525,3550,-25,40.131.000,Neutral,0.0
16/11/2021,3613,3613,3513,3525,88,76.140.200,Neutral,0.0
17/11/2021,3613,3625,3575,3613,0,72.789.600,Positive,0.4588
18/11/2021,3588,3613,3575,3600,-12,30.911.600,Positive,0.4588
19/11/2021,3625,3650,3575,3588,37,101.125.800,Positive,0.4588
22/11/2021,3675,3750,3613,3675,0,92.374.400,Neutral,0.0
23/11/2021,3575,3638,3550,3613,-38,63.127.600,Neutral,0.0
24/11/2021,3575,3588,3550,3563,12,56.217.000,Positive,0.5994
25/11/2021,3675,3688,3588,3613,62,97.473.400,Neutral,0.0
26/11/2021,3550,3663,3538,3663,-113,78.633.400,Neutral,0.0
29/11/2021,3588,3638,3463,3550,38,112.673.000,Neutral,0.0
30/11/2021,3500,3625,3475,3625,-125,219.340.400,Neutral,0.0
01/12/2021,3538,3563,3475,3500,38,93.119.800,Neutral,0.0
02/12/2021,3600,3625,3500,3538,62,70.416.400,Neutral,0.0
03/12/2021,3575,3613,3550,3600,-25,46.109.400,Neutral,0.0
06/12/2021,3588,3625,3550,3575,13,52.050.400,Neutral,0.0
07/12/2021,3650,3650,3588,3588,62,64.289.400,Positive,0.9042
08/12/2021,3575,3650,3575,3638,-63,56.064.200,Neutral,0.0
09/12/2021,3675,3675,3563,3625,50,42.688.600,Positive,0.2732
10/12/2021,3600,3613,3550,3600,0,93.532.200,Neutral,0.0
13/12/2021,3563,3613,3563,3600,-37,50.091.200,Positive,0.0772
14/12/2021,3588,3600,3550,3563,25,65.061.400,Neutral,0.0
15/12/2021,3638,3663,3563,3575,63,75.677.400,Positive,"0,8522"
16/12/2021,3625,3663,3600,3650,-25,69.082.400,Negative,"-0,3498"
17/12/2021,3575,3613,3538,3613,-38,83.945.200,Neutral,0.0
20/12/2021,3538,3575,3538,3550,-12,57.932.600,Negative,-0.4019
21/12/2021,3575,3625,3550,3575,0,49.859.600,Positive,0.4215
22/12/2021,3525,3600,3525,3588,-63,34.814.400,Positive,0.2023
23/12/2021,3538,3575,3525,3525,13,44.565.000,Neutral,0.0
24/12/2021,3525,3575,3475,3550,-25,54.902.200,Positive,0.1779
27/12/2021,3500,3550,3488,3525,-25,34.096.400,Negative,"-0,2135"
28/12/2021,3525,3525,3488,3525,0,39.835.400,Neutral,0.0
29/12/2021,3550,3563,3500,3538,12,20.860.200,Positive,0.4939
30/12/2021,3513,3563,3513,3550,-37,34.951.600,Negative,"-0,4382"
03/01/2022,3525,3563,3513,3550,-25,30.999.600,Negative,"-0,1784"
04/01/2022,3588,3600,3525,3538,50,44.541.400,Positive,"0,5318"
05/01/2022,3513,3588,3463,3575,-62,98.910.200,Negative,"-0,4163"
06/01/2022,3513,3538,3475,3538,-25,65.651.200,Negative,"-0,3914"
07/01/2022,3525,3550,3513,3513,12,68.452.800,Positive,"0,2676"
10/01/2022,3525,3550,3525,3538,-13,44.378.600,Negative,"-0,2256"
11/01/2022,3525,3550,3500,3550,-25,50.367.600,Negative,"-0,4831"
12/01/2022,3575,3575,3525,3525,50,34.249.200,Positive,"0,8407"
13/01/2022,3563,3588,3550,3575,-12,35.763.800,Negative,"-0,1917"
14/01/2022,3588,3613,3538,3538,50,43.651.400,Positive,"0,6804"
17/01/2022,3600,3638,3575,3625,-25,43.188.000,Negative,"-0,4745"
18/01/2022,3625,3625,3550,3588,37,64.484.800,Positive,"0,7679"
19/01/2022,3513,3600,3500,3588,-75,103.093.600,Negative,"-0,1627"
20/01/2022,3588,3588,3513,3550,38,53.067.000,Positive,"0,1517"
21/01/2022,3650,3650,3563,3588,62,76.806.800,Positive,"0,8763"
24/01/2022,3638,3638,3600,3638,0,44.476.800,Positive,"0,8051"
25/01/2022,3613,3625,3575,3600,13,69.268.000,Positive,"0,065"
26/01/2022,3738,3738,3613,3650,88,140.636.400,Positive,"0,7759"
27/01/2022,3775,3800,3700,3738,37,113.618.000,Positive,"0,0378"
28/01/2022,3825,3825,3775,3813,12,121.145.200,Positive,"0,4742"
31/01/2022,3738,3888,3725,3888,-150,101.700.800,Negative,"-0,4347"
02/02/2022,3738,3763,3725,3763,-25,68.769.000,Negative,"-0,1646"
03/02/2022,3738,3738,3675,3738,0,60.204.000,Positive,"0,2111"
04/02/2022,3738,3763,3700,3725,13,36.629.400,Positive,"0,8022"
07/02/2022,3750,3825,3738,3825,-75,68.867.800,Negative,"-0,3354"
08/02/2022,3813,3863,3775,3800,13,158.581.800,Positive,"0,0074"
09/02/2022,3838,3863,3800,3850,-12,107.360.800,Negative,"-0,4001"
10/02/2022,3863,3875,3825,3850,13,107.679.400,Positive,"0,9518"
11/02/2022,3863,3888,3825,3888,-25,81.582.600,Negative,"-0,2493"
14/02/2022,3900,3900,3813,3850,50,76.263.200,Positive,"0,2137"
15/02/2022,3950,3950,3838,3900,50,67.804.400,Positive,"0,9522"
16/02/2022,3925,3963,3875,3963,-38,74.785.000,Negative,"-0,3085"
17/02/2022,3925,3938,3838,3938,-13,103.038.800,Negative,"-0,1985"
18/02/2022,3925,3975,3875,3913,12,81.303.200,Positive,"0,3343"
21/02/2022,3925,3963,3925,3925,0,31.720.800,Positive,"0,669"
22/02/2022,3938,3950,3888,3913,25,69.476.600,Positive,"0,1296"
23/02/2022,3938,3975,3913,3963,-25,85.991.000,Negative,"-0,3048"
24/02/2022,3850,3938,3825,3863,-13,170.297.000,Negative,"-0,4236"
25/02/2022,3850,3875,3825,3863,-13,163.299.800,Negative,"-0,226"
01/03/2022,3825,3925,3825,3838,-13,149.532.200,Negative,"-0,1776"
02/03/2022,3813,3863,3775,3825,-12,110.824.000,Negative,"-0,2417"
04/03/2022,3825,3863,3800,3850,-25,104.914.600,Negative,"-0,4068"
07/03/2022,3775,3813,3750,3775,0,137.667.600,Positive,"0,3122"
08/03/2022,3775,3850,3775,3813,-38,104.072.200,Negative,"-0,276"
09/03/2022,3813,3863,3788,3788,25,115.109.200,Positive,"0,0187"
10/03/2022,3838,3875,3800,3850,-12,105.803.000,Negative,"-0,4372"
11/03/2022,3825,3863,3800,3863,-38,122.401.600,Negative,"-0,1282"
14/03/2022,3875,3913,3813,3825,50,173.513.400,Positive,"0,2683"
15/03/2022,3888,3938,3888,3900,-12,146.735.400,Negative,"-0,3932"
16/03/2022,3975,4025,3900,3900,75,291.909.800,Positive,"0,628"
17/03/2022,3975,4050,3975,4000,-25,235.559.000,Negative,"-0,1867"
18/03/2022,3963,4000,3938,3988,-25,212.233.400,Negative,"-0,1281"
21/03/2022,3825,3863,3800,3838,-13,162.364.400,Negative,"-0,1019"
22/03/2022,3838,3875,3825,3850,-12,112.672.400,Negative,"-0,4137"
23/03/2022,3888,3900,3825,3838,50,183.894.800,Positive,"0,2239"
24/03/2022,3963,3963,3850,3850,113,210.909.800,Positive,"0,3714"
25/03/2022,3925,3988,3888,3975,-50,136.083.000,Negative,"-0,286"
28/03/2022,3938,3950,3900,3938,0,95.354.400,Positive,"0,6377"
29/03/2022,3963,4013,3938,3988,-25,160.112.200,Negative,"-0,4228"
30/03/2022,3938,3988,3925,3975,-37,82.476.000,Negative,"-0,292"
31/03/2022,3950,3988,3925,3963,-13,69.174.000,Negative,"-0,454"
01/04/2022,3938,3950,3888,3950,-12,62.912.400,Negative,"-0,3381"
04/04/2022,3913,3950,3888,3913,0,82.013.800,Positive,"0,2012"
05/04/2022,3913,3938,3900,3900,13,82.378.200,Positive,"0,2873"
06/04/2022,3838,3900,3825,3900,-62,129.476.400,Negative,"-0,4856"
07/04/2022,3850,3888,3813,3838,12,136.162.800,Positive,"0,0131"
08/04/2022,3850,3900,3838,3900,-50,94.622.400,Negative,"-0,2034"
11/04/2022,3838,3875,3825,3850,-12,107.966.400,Negative,"-0,278"
12/04/2022,3850,3875,3813,3838,12,92.691.200,Positive,"0,1874"
13/04/2022,3863,3875,3825,3838,25,90.558.600,Positive,"0,888"
14/04/2022,3838,3875,3825,3863,-25,63.275.600,Negative,"-0,4749"
18/04/2022,3813,3863,3788,3838,-25,101.496.000,Negative,"-0,218"
19/04/2022,3788,3838,3788,3813,-25,104.508.400,Negative,"-0,2003"
20/04/2022,3925,3950,3813,3825,100,164.354.800,Positive,"0,3974"
21/04/2022,4150,4200,3963,4000,150,337.363.200,Positive,"0,5019"
22/04/2022,4138,4163,4038,4100,38,168.301.800,Positive,"0,631"
25/04/2022,4113,4225,4013,4100,13,179.082.600,Positive,"0,1953"
26/04/2022,4175,4213,4113,4125,50,131.930.600,Positive,"0,3781"
27/04/2022,4113,4213,4113,4138,-25,118.272.800,Negative,"-0,4537"
28/04/2022,4475,4538,4338,4388,87,443.163.800,Positive,"0,1986"
09/05/2022,4163,4338,4163,4313,-150,351.637.800,Negative,"-0,1858"
10/05/2022,4050,4088,3913,3913,137,498.444.800,Positive,"0,7882"
11/05/2022,4000,4100,4000,4050,-50,198.922.600,Negative,"-0,4256"
12/05/2022,3938,4025,3863,3988,-50,162.727.200,Negative,"-0,233"
13/05/2022,3900,3950,3875,3938,-38,165.507.800,Negative,"-0,2689"
17/05/2022,3925,4000,3900,3900,25,149.548.800,Positive,"0,294"
18/05/2022,3950,4013,3900,3988,-38,162.519.200,Negative,"-0,3885"
19/05/2022,3950,3963,3875,3900,50,127.740.400,Positive,"0,6849"
20/05/2022,4000,4025,3975,3975,25,106.866.400,Positive,"0,6118"
23/05/2022,3938,4038,3900,4025,-87,144.005.200,Negative,"-0,1692"
24/05/2022,3963,4025,3950,3975,-12,134.555.000,Negative,"-0,1272"
25/05/2022,3925,4025,3913,3950,-25,132.635.400,Negative,"-0,4709"
27/05/2022,4050,4063,3975,4000,50,155.078.600,Positive,"0,33"
30/05/2022,4100,4100,4000,4100,0,117.617.200,Positive,"0,4045"
31/05/2022,4250,4250,4113,4138,112,262.054.000,Positive,"0,7202"
02/06/2022,4100,4175,4025,4163,-63,203.021.800,Negative,"-0,1876"
03/06/2022,4100,4150,4100,4138,-38,147.960.000,Negative,"-0,3051"
06/06/2022,4075,4175,4013,4100,-25,148.785.000,Negative,"-0,1802"
07/06/2022,4150,4175,4075,4100,50,132.673.800,Positive,"0,3947"
08/06/2022,4200,4213,4075,4113,87,153.409.200,Positive,"0,0623"
09/06/2022,4213,4250,4175,4200,13,216.804.400,Positive,"0,7674"
10/06/2022,4088,4163,4075,4138,-50,165.119.600,Negative,"-0,114"
13/06/2022,4050,4050,3975,4000,50,122.467.200,Positive,"0,0369"
14/06/2022,4100,4100,4000,4000,100,100.136.600,Positive,"0,1326"
15/06/2022,4150,4163,4063,4063,87,142.400.800,Positive,"0,0821"
16/06/2022,4188,4250,4150,4250,-62,186.692.600,Neutral,0.0
17/06/2022,4038,4125,4038,4088,-50,156.836.200,Positive,0.5106
20/06/2022,4125,4125,4025,4050,75,74.978.200,Neutral,0.0
21/06/2022,4125,4175,4100,4150,-25,62.996.600,Neutral,0.0
22/06/2022,4075,4138,4063,4100,-25,88.306.600,Neutral,0.0
23/06/2022,4075,4113,4050,4075,0,48.817.400,Neutral,0.0
24/06/2022,4150,4150,4075,4100,50,60.638.400,Neutral,0.0
27/06/2022,4113,4200,4038,4200,-87,76.574.400,Positive,0.2023
28/06/2022,4063,4100,4000,4075,-12,110.131.200,Negative,"-0,4426"
29/06/2022,3975,4063,3975,4050,-75,113.216.400,Negative,"-0,1444"
30/06/2022,3963,4050,3950,4000,-37,125.507.600,Neutral,0.0
01/07/2022,3800,3963,3788,3938,-138,191.672.200,Neutral,0.0
04/07/2022,3700,3838,3638,3788,-88,246.417.000,Neutral,0.0
05/07/2022,3825,3863,3725,3725,100,90.919.800,Negative,-0.3612
06/07/2022,3763,3825,3675,3825,-62,180.812.800,Neutral,0.0
07/07/2022,3713,3775,3713,3750,-37,120.444.800,Neutral,0.0
08/07/2022,3738,3775,3700,3775,-37,57.156.600,Neutral,0.0
11/07/2022,3738,3763,3700,3738,0,22.860.800,Negative,-0.296
12/07/2022,3713,3738,3688,3738,-25,51.524.400,Negative,"-0,499"
13/07/2022,3638,3713,3638,3700,-62,142.494.200,Neutral,0.0
14/07/2022,3638,3688,3600,3625,13,158.438.200,Neutral,0.0
15/07/2022,3588,3700,3588,3650,-62,191.949.400,Neutral,0.0
18/07/2022,3675,3675,3613,3613,62,152.078.400,Positive,"0,2887"
19/07/2022,3713,3725,3638,3675,38,128.963.600,Positive,"0,4086"
20/07/2022,3950,3975,3775,3775,175,215.712.600,Neutral,0.0
21/07/2022,3950,4000,3863,4000,-50,125.699.200,Neutral,0.0
22/07/2022,3925,3963,3888,3963,-38,54.461.200,Positive,0.34
25/07/2022,3888,3950,3888,3938,-50,30.750.600,Neutral,0.0
26/07/2022,4000,4013,3900,3913,87,58.317.600,Neutral,0.0
27/07/2022,4050,4063,4000,4025,25,87.439.200,Positive,0.25
28/07/2022,4025,4100,4013,4013,12,94.427.400,Neutral,0.0
29/07/2022,4138,4175,4075,4113,25,132.709.400,Neutral,0.0
01/08/2022,3988,4113,3988,4100,-112,95.909.000,Positive,0.2263
02/08/2022,4088,4088,3988,4000,88,57.458.200,Positive,0.1779
03/08/2022,4125,4125,4025,4088,37,55.822.800,Positive,0.2732
04/08/2022,4125,4150,4075,4150,-25,75.188.600,Positive,0.1779
05/08/2022,4125,4150,4088,4138,-13,64.150.800,Neutral,0.0
08/08/2022,4175,4175,4113,4125,50,82.522.000,Neutral,0.0
09/08/2022,4238,4300,4200,4213,25,117.148.200,Neutral,0.0
10/08/2022,4300,4300,4125,4175,125,79.950.200,Neutral,0.0
11/08/2022,4263,4338,4213,4313,-50,106.627.400,Positive,0.4939
12/08/2022,4238,4288,4213,4263,-25,62.626.200,Neutral,0.0
15/08/2022,4225,4275,4200,4225,0,44.464.800,Neutral,0.0
16/08/2022,4263,4325,4238,4275,-12,109.260.400,Neutral,0.0
18/08/2022,4300,4400,4288,4388,-88,116.693.200,Neutral,0.0
19/08/2022,4250,4325,4250,4300,-50,48.290.200,Positive,0.296
22/08/2022,4263,4275,4175,4213,50,121.399.800,Neutral,0.0
23/08/2022,4313,4338,4225,4250,63,95.553.400,Neutral,0.0
24/08/2022,4313,4350,4275,4300,13,60.958.200,Neutral,0.0
25/08/2022,4288,4313,4213,4275,13,77.254.800,Neutral,0.0
26/08/2022,4250,4325,4250,4313,-63,82.356.600,Positive,0.1779
29/08/2022,4275,4300,4175,4200,75,62.683.800,Positive,"0,0555"
30/08/2022,4325,4375,4288,4313,12,109.649.400,Positive,"0,9179"
31/08/2022,4425,4425,4225,4250,175,151.631.600,Positive,"0,9311"
01/09/2022,4463,4475,4338,4425,38,120.967.800,Neutral,0.0
02/09/2022,4425,4500,4363,4488,-63,90.044.600,Neutral,0.0
05/09/2022,4475,4500,4400,4425,50,60.491.000,Neutral,0.0
06/09/2022,4413,4500,4400,4488,-75,65.296.200,Positive,0.1779
07/09/2022,4438,4438,4363,4388,50,97.771.400,Positive,"0,0237"
08/09/2022,4475,4550,4413,4450,25,96.931.000,Neutral,0.0
09/09/2022,4538,4550,4475,4538,0,128.510.800,Neutral,0.0
12/09/2022,4588,4600,4538,4575,13,110.819.000,Positive,0.5267
13/09/2022,4725,4750,4613,4625,100,185.487.800,Neutral,0.0
14/09/2022,4650,4700,4600,4638,12,119.631.200,Neutral,0.0
15/09/2022,4675,4750,4650,4700,-25,156.750.600,Neutral,0.0
16/09/2022,4550,4650,4513,4638,-88,167.812.600,Neutral,0.0
19/09/2022,4613,4650,4575,4625,-12,137.396.600,Neutral,0.0
20/09/2022,4600,4688,4600,4663,-63,140.752.200,Neutral,0.0
21/09/2022,4638,4638,4550,4575,63,71.044.400,Neutral,0.0
22/09/2022,4600,4650,4588,4638,-38,96.479.200,Neutral,0.0
23/09/2022,4600,4625,4575,4600,0,61.877.000,Positive,"0,7204"
26/09/2022,4625,4688,4475,4563,62,133.769.600,Neutral,0.0
27/09/2022,4675,4675,4600,4625,50,130.959.400,Neutral,0.0
28/09/2022,4650,4800,4638,4725,-75,133.085.000,Neutral,0.0
29/09/2022,4625,4688,4600,4675,-50,67.945.200,Neutral,0.0
30/09/2022,4713,4713,4613,4650,63,113.501.000,Neutral,0.0
03/10/2022,4638,4688,4613,4663,-25,54.662.400,Neutral,0.0
04/10/2022,4613,4688,4613,4650,-37,90.247.000,Positive,0.8225
05/10/2022,4638,4738,4638,4650,-12,75.891.600,Neutral,0.0
06/10/2022,4663,4663,4613,4650,13,43.279.200,Neutral,0.0
07/10/2022,4713,4713,4638,4663,50,51.267.000,Neutral,0.0
10/10/2022,4650,4700,4638,4688,-38,55.465.000,Neutral,0.0
11/10/2022,4650,4713,4625,4713,-63,71.925.600,Negative,"-0,2181"
12/10/2022,4713,4750,4650,4688,25,118.731.400,Neutral,0.0
13/10/2022,4738,4775,4663,4750,-12,58.832.000,Neutral,0.0
14/10/2022,4700,4825,4688,4825,-125,106.401.600,Positive,0.3818
17/10/2022,4725,4738,4650,4725,0,60.905.200,Neutral,0.0
18/10/2022,4750,4788,4725,4750,0,67.904.400,Positive,"0,2367"
19/10/2022,4738,4788,4663,4688,50,71.544.800,Neutral,0.0
20/10/2022,4950,4963,4675,4675,275,102.422.400,Neutral,0.0
21/10/2022,5175,5225,4963,5000,175,183.987.800,Neutral,0.0
24/10/2022,5125,5250,5125,5163,-38,102.168.000,Neutral,0.0
25/10/2022,5113,5225,5113,5138,-25,83.305.200,Positive,0.1531
26/10/2022,5100,5125,5000,5113,-13,80.531.400,Positive,0.1779
27/10/2022,5100,5163,5025,5100,0,84.531.200,Positive,"0,3075"
28/10/2022,5100,5113,5050,5063,37,102.437.400,Positive,0.5423
31/10/2022,5275,5275,5113,5150,125,173.874.600,Positive,0.25
01/11/2022,5200,5300,5113,5300,-100,111.898.000,Neutral,0.0
02/11/2022,5038,5200,4988,5188,-150,127.515.400,Neutral,0.0
03/11/2022,5088,5100,4975,4975,113,119.598.600,Neutral,0.0
04/11/2022,5075,5075,5000,5013,62,70.781.200,Neutral,0.0
07/11/2022,5125,5125,5000,5088,37,98.034.400,Positive,0.5994
08/11/2022,5075,5138,5038,5138,-63,39.585.800,Positive,0.4588
09/11/2022,5075,5075,5025,5025,50,68.010.400,Neutral,0.0
10/11/2022,5050,5075,5000,5025,25,61.964.000,Neutral,0.0
11/11/2022,5213,5225,5113,5150,63,102.008.200,Neutral,0.0
14/11/2022,5125,5275,5075,5275,-150,61.055.200,Neutral,0.0
15/11/2022,5125,5150,5050,5150,-25,83.000.800,Neutral,0.0
16/11/2022,5000,5088,4950,5050,-50,128.257.800,Neutral,0.0
17/11/2022,4950,5013,4925,4925,25,167.562.600,Neutral,0.0
18/11/2022,5088,5113,4963,4975,113,111.646.200,Neutral,0.0
21/11/2022,5050,5100,5013,5088,-38,52.311.600,Positive,0.25
22/11/2022,5063,5125,5025,5025,38,79.850.600,Positive,"0,6287"
23/11/2022,5100,5150,5063,5063,37,78.250.600,Positive,"0,4715"
24/11/2022,5113,5150,5100,5113,0,59.701.400,Neutral,0.0
25/11/2022,5088,5113,5050,5113,-25,77.984.800,Positive,0.4215
28/11/2022,5063,5138,5063,5088,-25,64.779.000,Positive,0.4404
29/11/2022,5163,5225,5100,5125,38,72.261.000,Neutral,0.0
30/11/2022,5263,5400,5163,5163,100,347.136.800,Neutral,0.0
01/12/2022,5200,5325,5200,5263,-63,141.493.000,Negative,"-0,4924"
02/12/2022,5263,5263,5163,5200,63,70.811.400,Positive,0.8316
05/12/2022,5438,5500,5288,5325,113,146.472.800,Neutral,0.0
06/12/2022,5450,5500,5363,5438,12,139.360.200,Positive,"0,3435"
07/12/2022,5188,5350,5188,5313,-125,200.886.200,Positive,0.3612
08/12/2022,5025,5113,4988,5038,-13,279.908.400,Positive,0.4019
09/12/2022,4963,5025,4913,4975,-12,241.338.200,Neutral,0.0
12/12/2022,4975,5000,4888,4913,62,183.717.600,Neutral,0.0
13/12/2022,4950,5000,4888,4888,62,224.176.000,Positive,0.6486
14/12/2022,4975,5050,4975,5038,-63,162.689.200,Neutral,0.0
15/12/2022,4950,5013,4950,4950,0,82.673.400,Positive,0.4767
16/12/2022,5050,5050,4913,4913,137,770.252.400,Positive,0.5106
19/12/2022,5000,5038,4950,5000,0,100.871.400,Positive,0.128
20/12/2022,5025,5025,4975,5000,25,56.633.800,Positive,"0,2914"
21/12/2022,5000,5063,5000,5063,-63,37.945.200,Negative,"-0,3027"
22/12/2022,4975,5050,4975,5050,-75,78.836.200,Neutral,0.0
23/12/2022,4963,5000,4950,4950,13,38.571.200,Neutral,0.0
26/12/2022,5025,5025,4975,4988,37,19.578.800,Neutral,0.0
27/12/2022,4975,5025,4938,5025,-50,43.282.000,Positive,0.1779
28/12/2022,4988,5000,4925,5000,-12,30.258.400,Positive,0.1779
29/12/2022,4988,4988,4938,4950,38,56.981.400,Neutral,0.0
30/12/2022,4963,5025,4963,5000,-37,40.655.800,Negative,"-0,4088"
02/01/2023,4938,4988,4938,4963,-25,5.985.400,Neutral,0.0
03/01/2023,4975,4988,4925,4925,50,13.815.200,Positive,0.1779
04/01/2023,5013,5038,4988,5013,0,38.575.800,Neutral,0.0
05/01/2023,4913,5025,4863,5025,-112,84.945.800,Neutral,0.0
06/01/2023,4900,4900,4800,4863,37,44.097.000,Positive,"0,1142"
09/01/2023,4863,4925,4800,4875,-12,67.250.600,Neutral,0.0
10/01/2023,4638,4775,4588,4750,-112,214.538.800,Neutral,0.0
11/01/2023,4475,4588,4450,4538,-63,193.915.000,Neutral,0.0
12/01/2023,4600,4725,4500,4500,100,219.659.400,Positive,0.5719
13/01/2023,4588,4613,4525,4563,25,107.483.800,Neutral,0.0
16/01/2023,4650,4675,4550,4550,100,145.710.000,Positive,0.34
17/01/2023,4875,4913,4688,4700,175,146.238.000,Neutral,0.0
18/01/2023,4775,4888,4750,4825,-50,95.360.600,Neutral,0.0
19/01/2023,4875,4913,4763,4800,75,81.704.200,Neutral,0.0
20/01/2023,4988,5000,4900,4925,63,93.227.400,Positive,0.1779
24/01/2023,4950,4988,4900,4925,25,35.028.000,Neutral,0.0
25/01/2023,4850,4925,4850,4900,-50,72.767.800,Neutral,0.0
26/01/2023,4913,4938,4875,4888,25,70.558.600,Neutral,0.0
27/01/2023,5013,5075,4950,4950,63,216.788.400,Neutral,0.0
30/01/2023,4975,5063,4938,5013,-38,82.589.400,Neutral,0.0
31/01/2023,4975,5050,4938,5013,-38,167.297.000,Neutral,0.0
01/02/2023,4850,5025,4838,4975,-125,165.628.800,Neutral,0.0
02/02/2023,4863,4875,4788,4863,0,99.351.800,Neutral,0.0
03/02/2023,4963,4975,4875,4875,88,108.125.400,Neutral,0.0
06/02/2023,4938,5025,4875,4963,-25,109.098.400,Neutral,0.0
07/02/2023,5088,5113,4950,4975,113,118.132.000,Neutral,0.0
08/02/2023,5100,5113,5050,5063,37,75.656.000,Neutral,0.0
09/02/2023,5125,5200,5125,5150,-25,121.757.400,Neutral,0.0
10/02/2023,5150,5225,5075,5225,-75,81.114.600,Positive,0.1779
13/02/2023,5175,5275,5125,5275,-100,56.771.800,Neutral,0.0
14/02/2023,5188,5225,5138,5225,-37,39.570.600,Negative,"-0,2591"
15/02/2023,5113,5175,5050,5150,-37,75.595.200,Neutral,0.0
16/02/2023,5088,5138,5063,5113,-25,49.569.000,Positive,0.6908
17/02/2023,5150,5150,5050,5088,62,58.521.000,Negative,-0.128
20/02/2023,5138,5150,5100,5150,-12,40.696.400,Neutral,0.0
21/02/2023,5100,5150,5088,5150,-50,52.604.400,Neutral,0.0
22/02/2023,5000,5088,4975,5063,-63,75.513.400,Positive,0.4404
23/02/2023,5038,5050,4963,4988,50,177.505.200,Positive,0.5106
24/02/2023,5063,5113,5038,5063,0,54.138.200,Neutral,0.0
27/02/2023,5075,5075,5025,5038,37,47.901.800,Positive,0.25
28/02/2023,5000,5075,5000,5038,-38,146.440.400,Positive,0.5106
01/03/2023,5050,5100,5025,5075,-25,89.565.600,Neutral,0.0
02/03/2023,5113,5150,5075,5075,38,72.991.800,Neutral,0.0
03/03/2023,5025,5125,5013,5100,-75,88.630.600,Neutral,0.0
06/03/2023,5063,5113,5038,5088,-25,53.728.800,Negative,"-0,133"
07/03/2023,5088,5138,5063,5075,13,80.065.800,Positive,0.5994
08/03/2023,5138,5138,5088,5125,13,104.838.200,Neutral,0.0
09/03/2023,5225,5250,5175,5200,25,83.286.000,Positive,0.34
10/03/2023,5188,5213,5138,5213,-25,107.531.000,Negative,-0.4588
13/03/2023,5175,5188,5113,5138,37,92.827.600,Positive,"0,3516"
14/03/2023,4963,5138,4925,5100,-137,191.898.400,Neutral,0.0
15/03/2023,5025,5088,4925,5025,0,262.828.600,Neutral,0.0
16/03/2023,4925,5038,4913,5038,-113,135.467.400,Neutral,0.0
17/03/2023,5050,5063,4963,4975,75,224.171.600,Neutral,0.0
20/03/2023,5000,5050,5000,5025,-25,46.333.000,Neutral,0.0
21/03/2023,5250,5250,5038,5050,200,131.331.000,Positive,0.1779
24/03/2023,5450,5475,5288,5313,137,222.156.200,Positive,"0,2867"
27/03/2023,5100,5213,5100,5200,-100,151.825.600,Neutral,0.0
28/03/2023,5063,5138,5050,5100,-37,103.951.000,Positive,0.1531
29/03/2023,5175,5188,5100,5125,50,107.454.600,Neutral,0.0
30/03/2023,5113,5200,5113,5175,-62,97.186.200,Neutral,0.0
31/03/2023,5163,5163,5100,5138,25,92.013.200,Neutral,0.0
03/04/2023,5263,5263,5200,5200,63,101.724.400,Positive,"0,9812"
04/04/2023,5200,5300,5100,5250,-50,94.482.600,Neutral,0.0
05/04/2023,5225,5250,5150,5150,75,42.655.500,Neutral,0.0
06/04/2023,5175,5225,5150,5225,-50,47.999.400,Negative,"-0,331"
10/04/2023,5100,5175,5050,5150,-50,74.787.800,Negative,"-0,1195"
11/04/2023,5100,5100,5050,5100,0,37.744.800,Positive,"0,9511"
12/04/2023,5150,5225,5100,5100,50,111.901.500,Positive,"0,1366"
13/04/2023,5125,5200,5125,5175,-50,67.928.500,Negative,"-0,2115"
14/04/2023,5225,5250,5150,5150,75,142.479.800,Positive,"0,5706"
17/04/2023,5125,5250,5125,5225,-100,95.789.900,Negative,-0.1779
18/04/2023,5175,5250,5125,5150,25,106.962.300,Neutral,0.0
26/04/2023,5200,5425,5175,5400,-200,207.338.000,Positive,0.2263
27/04/2023,5200,5225,5175,5175,25,51.076.300,Positive,0.9081
28/04/2023,5175,5225,5150,5225,-50,116.957.800,Neutral,0.0
02/05/2023,5250,5250,5175,5250,0,98.024.100,Neutral,0.0
03/05/2023,5225,5250,5150,5250,-25,110.683.000,Negative,"-0,104"
04/05/2023,5175,5225,5125,5175,0,100.945.900,Neutral,0.0
05/05/2023,5175,5200,5125,5175,0,64.499.500,Neutral,0.0
08/05/2023,5125,5200,5125,5175,-50,64.678.000,Negative,"-0,2657"
09/05/2023,5050,5125,5050,5100,-50,93.531.000,Negative,"-0,2574"
10/05/2023,5075,5125,5050,5050,25,58.148.200,Neutral,0.0
11/05/2023,5100,5100,5025,5075,25,63.262.300,Neutral,0.0
12/05/2023,5000,5075,5000,5075,-75,105.407.300,Neutral,0.0
15/05/2023,5050,5050,5000,5050,0,76.451.700,Neutral,0.0
16/05/2023,4990,5075,4980,5075,-85,42.752.200,Neutral,0.0
17/05/2023,5000,5075,4980,4990,10,63.396.700,Neutral,0.0
19/05/2023,5075,5100,5025,5075,0,78.499.800,Negative,-0.1779
22/05/2023,5225,5250,5075,5100,125,120.027.200,Neutral,0.0
23/05/2023,5125,5250,5100,5200,-75,165.534.100,Neutral,0.0
24/05/2023,5075,5150,5050,5125,-50,125.575.300,Neutral,0.0
25/05/2023,5175,5175,5050,5050,125,76.424.100,Positive,"0,7315"
26/05/2023,5125,5200,5100,5175,-50,42.313.700,Negative,"-0,3665"
29/05/2023,5150,5175,5100,5175,-25,60.646.900,Negative,"-0,1365"
30/05/2023,5150,5200,5100,5100,50,49.086.100,Negative,-0.2263
31/05/2023,5050,5200,5050,5175,-125,393.735.900,Neutral,0.0
05/06/2023,5075,5150,5075,5100,-25,149.191.300,Negative,"-0,4059"
06/06/2023,5050,5100,4950,5050,0,244.590.500,Positive,"0,5607"
07/06/2023,5025,5075,5000,5000,25,130.408.700,Positive,"0,0085"
08/06/2023,5025,5075,5000,5000,25,173.484.200,Positive,"0,327"
09/06/2023,5125,5125,5000,5025,100,150.849.200,Neutral,0.0
12/06/2023,5100,5125,5050,5100,0,91.080.300,Neutral,0.0
13/06/2023,5100,5175,5050,5100,0,143.804.700,Neutral,0.0
14/06/2023,5050,5150,5050,5125,-75,96.670.300,Negative,"-0,2907"
15/06/2023,5125,5150,5050,5050,75,94.097.900,Positive,"0,8611"
16/06/2023,5150,5150,5075,5125,25,103.942.500,Positive,"0,0264"
19/06/2023,5125,5150,5100,5100,25,36.211.300,Positive,0.4019
20/06/2023,5100,5125,5050,5100,0,44.316.800,Neutral,0.0
21/06/2023,5100,5100,5050,5050,50,58.061.600,Neutral,0.0
22/06/2023,5075,5150,5075,5100,-25,60.457.300,Neutral,0.0
23/06/2023,5075,5125,5050,5075,0,47.276.900,Neutral,0.0
26/06/2023,5125,5175,5075,5100,25,74.263.700,Neutral,0.0
27/06/2023,5200,5250,5150,5175,25,101.592.900,Neutral,0.0
03/07/2023,5350,5350,5125,5125,225,227.354.700,Positive,"0,1921"
04/07/2023,5250,5400,5225,5400,-150,119.841.200,Negative,"-0,3604"
05/07/2023,5275,5325,5250,5300,-25,78.430.000,Negative,"-0,3189"
06/07/2023,5300,5350,5250,5300,0,90.981.000,Positive,"0,1249"
07/07/2023,5150,5300,5150,5275,-125,128.515.100,Negative,"-0,3064"
10/07/2023,5175,5225,5150,5175,0,82.685.700,Neutral,0.0
11/07/2023,5275,5300,5175,5200,75,100.578.900,Neutral,0.0
12/07/2023,5300,5375,5250,5300,0,123.947.700,Neutral,0.0
13/07/2023,5350,5375,5275,5375,-25,101.281.200,Negative,"-0,3579"
14/07/2023,5400,5425,5350,5400,0,122.343.600,Positive,"0,5809"
17/07/2023,5375,5475,5375,5425,-50,99.897.600,Neutral,0.0
18/07/2023,5350,5425,5300,5375,-25,65.073.800,Neutral,0.0
20/07/2023,5525,5550,5400,5400,125,132.054.000,Neutral,0.0
21/07/2023,5550,5575,5450,5550,0,111.275.700,Neutral,0.0
24/07/2023,5500,5625,5500,5550,-50,54.865.000,Neutral,0.0
25/07/2023,5550,5575,5500,5550,0,65.237.300,Positive,0.296
26/07/2023,5575,5600,5525,5550,25,88.526.700,Positive,"0,956"
27/07/2023,5625,5700,5575,5575,50,86.556.200,Positive,0.1779
28/07/2023,5700,5725,5625,5625,75,121.968.500,Neutral,0.0
31/07/2023,5725,5800,5625,5800,-75,189.375.700,Positive,0.5574
01/08/2023,5650,5725,5600,5650,0,114.702.500,Positive,"0,5978"
02/08/2023,5700,5750,5600,5625,75,133.546.200,Positive,0.5423
03/08/2023,5800,5825,5700,5725,75,68.587.500,Neutral,0.0
04/08/2023,5775,5825,5750,5800,-25,47.144.200,Negative,-0.34
07/08/2023,5875,5925,5825,5850,25,104.342.100,Neutral,0.0
08/08/2023,5900,5950,5875,5900,0,66.473.200,Negative,-0.1779
09/08/2023,5900,5950,5850,5900,0,64.495.400,Neutral,0.0
10/08/2023,5975,6000,5900,5925,50,78.859.600,Positive,0.5719
11/08/2023,5925,6025,5900,5975,-50,46.568.600,Neutral,0.0
14/08/2023,5950,5950,5800,5925,25,86.460.500,Negative,-0.6249
15/08/2023,5800,5925,5800,5900,-100,116.815.700,Negative,"-0,4757"
16/08/2023,5800,5800,5675,5775,25,163.744.100,Positive,"0,8858"
18/08/2023,5775,5825,5725,5725,50,104.894.600,Positive,"0,3571"
21/08/2023,5825,5875,5800,5800,25,61.845.800,Neutral,0.0
22/08/2023,5950,5950,5800,5800,150,93.617.200,Positive,0.5994
23/08/2023,5850,5950,5850,5950,-100,40.844.700,Negative,"-0,1507"
24/08/2023,5950,5950,5875,5900,50,42.648.300,Positive,"0,0515"
25/08/2023,5900,5925,5825,5900,0,65.093.100,Positive,"0,0615"
28/08/2023,6000,6025,5900,5950,50,63.980.400,Positive,"0,2628"
29/08/2023,5950,6025,5950,6000,-50,50.839.300,Negative,"-0,2613"
30/08/2023,5975,6100,5925,5925,50,65.727.400,Neutral,0.0
31/08/2023,6025,6075,5900,6000,25,159.062.900,Neutral,0.0
01/09/2023,6075,6125,6050,6075,0,50.796.000,Neutral,0.0
04/09/2023,6100,6150,6050,6075,25,56.317.700,Neutral,0.0
05/09/2023,6100,6150,6075,6100,0,24.893.100,Neutral,0.0
06/09/2023,6050,6125,6050,6050,0,40.547.800,Negative,-0.2023
07/09/2023,5875,6025,5825,6000,-125,124.351.400,Neutral,0.0
08/09/2023,5900,5925,5775,5900,0,81.980.400,Positive,0.4767
11/09/2023,5925,5925,5825,5900,25,74.510.600,Positive,"0,1129"
12/09/2023,5875,5950,5850,5950,-75,54.076.800,Negative,"-0,1902"
13/09/2023,5850,5850,5775,5825,25,69.884.000,Positive,"0,4203"
14/09/2023,5825,5875,5775,5825,0,59.132.600,Positive,"0,927"
15/09/2023,5925,5975,5850,5900,25,165.106.200,Positive,0.4019
18/09/2023,5900,5950,5875,5900,0,53.450.400,Neutral,0.0
19/09/2023,6000,6075,5875,5900,100,84.608.400,Neutral,0.0
20/09/2023,6075,6125,6050,6100,-25,64.864.900,Neutral,0.0
21/09/2023,6000,6075,5975,6050,-50,60.535.000,Negative,"-0,1677"
22/09/2023,6000,6050,5975,6000,0,51.069.900,Positive,"0,2981"
25/09/2023,6000,6050,5975,6000,0,40.650.900,Positive,"0,3187"
26/09/2023,5925,6000,5850,5975,-50,109.786.400,Negative,"-0,2964"
27/09/2023,6000,6050,5900,5925,75,75.050.600,Positive,"0,4039"
29/09/2023,6025,6050,6000,6050,-25,71.554.100,Negative,"-0,4248"
02/10/2023,6050,6100,6025,6025,25,33.296.500,Neutral,0.0
03/10/2023,6075,6075,6000,6000,75,37.093.100,Neutral,0.0
04/10/2023,6125,6125,5975,6075,50,69.154.000,Positive,"0,9664"
05/10/2023,6125,6200,6100,6150,-25,69.566.800,Neutral,0.0
06/10/2023,6025,6150,6025,6150,-125,25.913.600,Neutral,0.0
09/10/2023,5900,6050,5900,6025,-125,45.321.700,Neutral,0.0
10/10/2023,6000,6075,5900,5900,100,42.820.800,Neutral,0.0
11/10/2023,6050,6175,5950,5950,100,72.955.000,Neutral,0.0
12/10/2023,6075,6175,6050,6075,0,91.341.800,Positive,"0,9345"
13/10/2023,6075,6150,6025,6075,0,39.914.700,Positive,"0,8269"
16/10/2023,6025,6075,5975,6025,0,53.416.400,Positive,"0,645"
17/10/2023,6000,6025,5925,6000,0,74.702.300,Neutral,0.0
18/10/2023,5850,5950,5825,5925,-75,80.637.400,Neutral,0.0
19/10/2023,5725,5800,5700,5775,-50,160.277.800,Negative,-0.1779
20/10/2023,5750,5800,5650,5675,75,82.132.000,Positive,"0,0071"
23/10/2023,5675,5725,5625,5700,-25,73.897.500,Negative,"-0,2072"
24/10/2023,5750,5800,5675,5700,50,72.469.200,Positive,"0,5515"
25/10/2023,5850,5900,5775,5825,25,90.426.500,Neutral,0.0
26/10/2023,5700,5850,5700,5800,-100,86.348.700,Neutral,0.0
27/10/2023,5700,5775,5700,5750,-50,90.177.000,Positive,0.4019
30/10/2023,5725,5725,5625,5700,25,81.547.000,Positive,"0,336"
31/10/2023,5675,5850,5650,5800,-125,99.449.400,Negative,"-0,2694"
01/11/2023,5650,5700,5625,5700,-50,74.281.200,Neutral,0.0
02/11/2023,5900,5925,5725,5750,150,115.678.200,Neutral,0.0
03/11/2023,5825,5975,5825,5925,-100,53.379.500,Neutral,0.0
06/11/2023,5925,5925,5850,5900,25,58.266.100,Neutral,0.0
07/11/2023,5875,5975,5800,5950,-75,56.161.300,Positive,0.5267
08/11/2023,5850,5850,5725,5775,75,63.442.400,Positive,"0,3906"
09/11/2023,5875,5900,5800,5825,50,45.026.200,Positive,"0,9828"
10/11/2023,5775,5850,5775,5850,-75,59.611.500,Negative,"-0,2967"
13/11/2023,5825,5850,5800,5850,-25,17.444.600,Neutral,0.0
14/11/2023,5825,5900,5800,5825,0,50.587.800,Neutral,0.0
15/11/2023,5925,5975,5875,5900,25,74.255.700,Positive,"0,8953"
16/11/2023,5925,5925,5825,5850,75,36.004.500,Positive,0.25
17/11/2023,5900,5950,5850,5875,25,33.963.900,Neutral,0.0
20/11/2023,5875,5925,5825,5825,50,20.014.600,Neutral,0.0
21/11/2023,5875,5925,5825,5850,25,55.094.300,Neutral,0.0
22/11/2023,5875,5900,5825,5825,50,21.111.100,Neutral,0.0
23/11/2023,5900,5950,5900,5950,-50,36.725.600,Negative,-0.1779
24/11/2023,5875,5925,5850,5925,-50,27.087.900,Negative,"-0,4351"
27/11/2023,5900,5925,5875,5900,0,39.719.300,Positive,"0,697"
28/11/2023,5900,5925,5875,5900,0,58.255.800,Positive,0.5267
29/11/2023,5850,5925,5825,5850,0,36.796.600,Neutral,0.0
30/11/2023,5850,5925,5825,5850,0,117.365.000,Positive,0.2263
01/12/2023,5900,5900,5825,5850,50,31.365.100,Positive,0.2732
04/12/2023,6000,6025,5900,5925,75,66.145.100,Positive,"0,1601"
05/12/2023,5975,6000,5875,6000,-25,58.668.400,Negative,"-0,3597"
06/12/2023,5800,5950,5800,5925,-125,88.747.200,Neutral,0.0
07/12/2023,5750,5825,5725,5800,-50,97.966.700,Neutral,0.0
08/12/2023,5700,5775,5650,5750,-50,98.036.700,Positive,0.5574
11/12/2023,5775,5800,5650,5650,125,68.655.000,Positive,"0,349"
12/12/2023,5800,5825,5750,5800,0,55.110.500,Positive,"0,0561"
13/12/2023,5725,5775,5700,5750,-25,121.450.600,Negative,"-0,4285"
14/12/2023,5950,6025,5800,5825,125,171.595.800,Neutral,0.0
15/12/2023,5900,6000,5900,5950,-50,142.382.200,Positive,0.25
18/12/2023,5925,5950,5850,5850,75,101.458.600,Neutral,0.0
19/12/2023,5975,5975,5925,5950,25,40.763.200,Positive,0.2263
20/12/2023,5925,5975,5900,5900,25,65.361.000,Positive,"0,2932"
21/12/2023,5975,5975,5925,5950,25,50.363.900,Neutral,0.0
22/12/2023,5975,5975,5925,5950,25,29.975.600,Neutral,0.0
27/12/2023,6000,6025,5925,6000,0,43.114.900,Neutral,0.0
28/12/2023,6125,6150,6000,6050,75,75.118.700,Neutral,0.0
29/12/2023,6050,6125,6000,6125,-75,63.097.100,Neutral,0.0
02/01/2024,6125,6125,6025,6050,75,26.235.700,Positive,"0,7257"
03/01/2024,6100,6150,6050,6100,0,30.053.900,Positive,"0,1555"
04/01/2024,6350,6400,6100,6125,225,135.344.500,Positive,0.4588
05/01/2024,6425,6475,6350,6400,25,114.339.400,Neutral,0.0
08/01/2024,6400,6600,6375,6500,-100,151.018.300,Neutral,0.0
09/01/2024,6375,6450,6350,6425,-50,77.953.400,Negative,"-0,2274"
10/01/2024,6425,6450,6325,6375,50,50.019.800,Positive,"0,5169"
11/01/2024,6450,6500,6400,6425,25,32.120.200,Positive,"0,1"
12/01/2024,6575,6675,6525,6575,0,114.039.700,Neutral,0.0
15/01/2024,6500,6625,6475,6575,-75,83.066.800,Negative,"-0,2205"
16/01/2024,6525,6625,6500,6525,0,83.516.800,Neutral,0.0
17/01/2024,6525,6625,6500,6525,0,80.929.000,Positive,0.25
18/01/2024,6525,6550,6475,6525,0,78.209.900,Neutral,0.0
19/01/2024,6525,6525,6425,6500,25,74.814.000,Neutral,0.0
22/01/2024,6500,6550,6450,6500,0,96.993.100,Positive,"0,005"
23/01/2024,6500,6550,6450,6525,-25,77.037.800,Negative,"-0,2235"
24/01/2024,6400,6475,6350,6450,-50,97.290.600,Negative,"-0,3755"
25/01/2024,6275,6400,6250,6325,-50,99.094.100,Neutral,0.0
26/01/2024,6300,6325,6225,6250,50,77.236.800,Neutral,0.0
29/01/2024,6475,6475,6275,6350,125,124.753.000,Positive,0.0516
30/01/2024,6650,6700,6450,6475,175,123.330.900,Positive,"0,3645"
31/01/2024,6650,6700,6650,6650,0,128.185.000,Positive,"0,6568"
01/02/2024,6550,6625,6500,6575,-25,168.145.800,Negative,"-0,4384"
02/02/2024,6675,6675,6600,6625,50,120.116.200,Positive,"0,9636"
05/02/2024,6825,6950,6675,6700,125,150.535.100,Positive,"0,8565"
06/02/2024,6850,6925,6775,6825,25,90.146.000,Positive,"0,8724"
07/02/2024,6950,6950,6850,6875,75,88.745.500,Positive,"0,0624"
12/02/2024,7100,7200,7050,7150,-50,162.771.300,Negative,"-0,3699"
13/02/2024,7025,7125,7025,7100,-75,102.668.900,Negative,"-0,1951"
15/02/2024,7200,7375,7150,7300,-100,220.530.000,Negative,"-0,2107"
16/02/2024,7200,7400,7200,7375,-175,142.022.100,Negative,"-0,2091"
19/02/2024,7150,7325,7125,7150,0,83.753.500,Positive,"0,3145"
20/02/2024,7150,7250,7150,7250,-100,87.312.000,Negative,"-0,4067"
21/02/2024,7250,7250,7075,7125,125,128.063.900,Positive,"0,652"
22/02/2024,7100,7200,7100,7175,-75,85.735.800,Negative,"-0,1742"
23/02/2024,7050,7100,7000,7050,0,109.404.700,Positive,"0,68"
26/02/2024,7050,7075,6950,6950,100,65.407.700,Neutral,0.0
27/02/2024,7075,7100,6975,6975,100,58.066.100,Neutral,0.0
28/02/2024,7125,7125,7025,7025,100,49.888.400,Positive,"0,1131"
29/02/2024,7000,7150,7000,7125,-125,150.713.600,Negative,"-0,2939"
01/03/2024,7025,7075,6975,7050,-25,90.739.400,Negative,"-0,4792"
04/03/2024,7025,7050,6975,7000,25,44.707.200,Positive,0.4939
05/03/2024,7025,7100,7000,7075,-50,92.557.200,Neutral,0.0
06/03/2024,7075,7100,7000,7000,75,74.178.100,Neutral,0.0
07/03/2024,7100,7125,7025,7075,25,94.950.400,Neutral,0.0
08/03/2024,7125,7175,7100,7150,-25,109.032.400,Neutral,0.0
13/03/2024,7275,7275,7150,7250,25,126.022.700,Neutral,0.0
14/03/2024,7400,7400,7225,7250,150,161.193.000,Positive,"0,1605"
15/03/2024,7400,7500,7275,7450,-50,250.581.100,Neutral,0.0
18/03/2024,7175,7425,7175,7425,-250,105.778.200,Positive,0.1779
19/03/2024,7275,7350,7225,7250,25,100.836.600,Positive,0.4019
20/03/2024,7050,7050,7000,7050,0,83.416.700,Neutral,0.0
21/03/2024,7050,7200,7050,7100,-50,81.774.800,Positive,0.4019
22/03/2024,7050,7075,6950,7000,50,65.219.900,Positive,"0,3409"
25/03/2024,7250,7250,7000,7250,0,78.212.700,Neutral,0.0
26/03/2024,7175,7225,7125,7225,-50,74.274.300,Neutral,0.0
27/03/2024,7175,7250,7175,7200,-25,46.295.700,Neutral,0.0
28/03/2024,7250,7250,7125,7150,100,90.900.900,Positive,"0,1477"
01/04/2024,6900,7250,6750,7250,-350,158.358.600,Neutral,0.0
02/04/2024,6900,6900,6700,6900,0,135.764.900,Neutral,0.0
03/04/2024,6775,6950,6675,6950,-175,115.372.600,Neutral,0.0
04/04/2024,6875,6925,6750,6750,125,63.174.900,Neutral,0.0
05/04/2024,6825,6900,6825,6825,0,46.111.500,Negative,-0.3182
16/04/2024,6625,6725,6300,6350,275,180.012.400,Neutral,0.0
17/04/2024,6625,6775,6625,6700,-75,83.840.200,Neutral,0.0
18/04/2024,6800,6900,6725,6800,0,106.893.900,Positive,0.25
19/04/2024,6725,6800,6650,6725,0,47.943.300,Positive,0.2023
22/04/2024,6725,6875,6575,6875,-150,121.727.900,Positive,0.3818
23/04/2024,6825,6925,6725,6850,-25,106.699.200,Neutral,0.0
24/04/2024,7050,7050,6900,6925,125,117.586.500,Neutral,0.0
25/04/2024,6950,7075,6925,7050,-100,111.803.500,Negative,"-0,1739"
26/04/2024,6750,7025,6750,7000,-250,125.875.000,Negative,-0.1779
29/04/2024,6925,6950,6650,6650,275,77.938.400,Neutral,0.0
30/04/2024,6900,7050,6775,6800,100,189.991.300,Positive,"0,6175"
02/05/2024,6325,6800,6050,6800,-475,501.849.300,Negative,"-0,2608"
03/05/2024,6150,6425,6050,6300,-150,269.305.400,Negative,"-0,2799"
06/05/2024,6275,6400,6150,6250,25,184.234.200,Positive,"0,2861"
07/05/2024,6275,6400,6250,6325,-50,130.410.300,Negative,"-0,4922"
08/05/2024,6275,6450,6250,6325,-50,117.065.300,Negative,"-0,3374"
13/05/2024,6200,6275,6125,6200,0,128.638.300,Positive,"0,8983"
14/05/2024,6200,6300,6175,6175,25,94.048.400,Positive,"0,8045"
15/05/2024,6375,6400,6200,6200,175,80.923.000,Positive,"0,1228"
16/05/2024,6350,6500,6325,6450,-100,114.806.300,Negative,"-0,1755"
17/05/2024,6575,6650,6350,6350,225,133.153.900,Positive,"0,7435"
20/05/2024,6325,6625,6200,6550,-225,168.796.000,Negative,"-0,4436"
21/05/2024,6025,6275,5975,6225,-200,307.362.900,Negative,"-0,3497"
22/05/2024,6050,6150,5950,6000,50,171.675.900,Positive,"0,7391"
27/05/2024,5825,6050,5825,6025,-200,258.450.900,Negative,"-0,3972"
28/05/2024,5950,6025,5825,5850,100,93.701.700,Positive,"0,7882"
29/05/2024,5800,5875,5700,5825,-25,169.386.300,Negative,"-0,1359"
30/05/2024,5875,6000,5525,5775,100,236.632.600,Positive,"0,1789"
31/05/2024,5900,6025,5900,6000,-100,169.567.000,Negative,"-0,2338"
03/06/2024,6100,6150,6025,6075,25,92.525.600,Negative,-0.2023
04/06/2024,6150,6275,6125,6150,0,137.800.600,Positive,0.2023
05/06/2024,6000,6150,5975,6125,-125,102.327.300,Neutral,0.0
06/06/2024,6175,6200,6075,6125,50,85.735.200,Positive,"0,9731"
07/06/2024,6275,6275,6150,6250,25,99.092.800,Positive,"0,5113"
10/06/2024,6275,6350,6200,6275,0,80.154.400,Positive,"0,6015"
11/06/2024,6125,6250,6125,6200,-75,56.254.400,Negative,"-0,3225"
12/06/2024,5925,6075,5900,6050,-125,120.857.200,Negative,"-0,3654"
13/06/2024,5875,6000,5850,5975,-100,162.616.700,Negative,"-0,2646"
14/06/2024,5750,5875,5650,5850,-100,203.241.500,Negative,"-0,3166"
19/06/2024,5750,5850,5675,5775,-25,116.004.200,Neutral,0.0
20/06/2024,5950,5950,5750,5825,125,82.660.000,Positive,"0,3434"
21/06/2024,6125,6200,6025,6050,75,184.240.600,Neutral,0.0
24/06/2024,6000,6125,6000,6075,-75,58.831.900,Neutral,0.0
25/06/2024,5925,5975,5825,5925,0,159.983.800,Neutral,0.0
26/06/2024,5850,6025,5850,5950,-100,92.895.700,Neutral,0.0
27/06/2024,6000,6075,5875,5900,100,117.602.400,Positive,"0,6453"
28/06/2024,6150,6250,6000,6000,150,191.371.600,Positive,"0,6066"
01/07/2024,6250,6250,6100,6175,75,100.408.200,Positive,0.3818
02/07/2024,6200,6350,6150,6275,-75,159.356.600,Neutral,0.0
03/07/2024,6225,6300,6100,6275,-50,70.017.100,Negative,"-0,2122"
04/07/2024,6250,6400,6225,6250,0,90.147.800,Positive,0.1779
05/07/2024,6425,6500,6300,6325,100,111.646.800,Neutral,0.0
08/07/2024,6225,6425,6200,6400,-175,138.144.000,Negative,-0.1779
09/07/2024,6375,6400,6200,6225,150,84.177.600,Neutral,0.0
10/07/2024,6375,6450,6300,6375,0,59.685.300,Neutral,0.0
11/07/2024,6400,6425,6350,6400,0,66.789.800,Neutral,-0.0
12/07/2024,6425,6550,6400,6450,-25,136.132.200,Negative,"-0,1354"
15/07/2024,6350,6450,6300,6450,-100,66.071.800,Negative,"-0,4192"
16/07/2024,6350,6400,6300,6400,-50,64.687.900,Neutral,0.0
17/07/2024,6450,6525,6375,6450,0,109.729.800,Neutral,0.0
18/07/2024,6550,6600,6500,6550,0,132.532.000,Neutral,0.0
19/07/2024,6525,6525,6450,6500,25,63.165.500,Positive,0.1779
22/07/2024,6700,6700,6525,6575,125,110.467.000,Positive,"0,4811"
23/07/2024,6625,6750,6550,6750,-125,77.861.700,Negative,"-0,107"
24/07/2024,6475,6575,6475,6500,-25,63.940.900,Negative,-0.2023
25/07/2024,6575,6575,6400,6450,125,66.655.400,Neutral,0.0
26/07/2024,6550,6625,6500,6575,-25,76.519.500,Neutral,0.0
29/07/2024,6475,6550,6450,6550,-75,54.435.300,Neutral,0.0
30/07/2024,6475,6550,6375,6475,0,86.701.400,Neutral,0.0
31/07/2024,6400,6475,6375,6400,0,99.004.100,Neutral,0.0
01/08/2024,6750,6750,6500,6550,200,163.086.200,Positive,0.1779
02/08/2024,6800,6875,6675,6700,100,167.892.400,Positive,"0,8249"
05/08/2024,6575,6725,6500,6700,-125,184.384.000,Negative,-0.2732
06/08/2024,6625,6700,6525,6650,-25,95.785.000,Neutral,0.0
07/08/2024,6775,6775,6650,6725,50,84.582.200,Neutral,-0.0
08/08/2024,6800,6850,6725,6800,0,81.408.500,Neutral,0.0
09/08/2024,6850,6900,6800,6825,25,79.710.700,Positive,"0,6581"
12/08/2024,6900,6900,6775,6875,25,50.756.000,Neutral,0.0
13/08/2024,7000,7000,6850,6850,150,68.666.000,Neutral,0.0
14/08/2024,7075,7100,7025,7075,0,97.695.100,Neutral,0.0
15/08/2024,7025,7075,6925,7075,-50,75.955.500,Negative,-0.1779
16/08/2024,7075,7125,7025,7075,0,64.266.400,Positive,0.743
19/08/2024,7150,7150,7025,7075,75,50.246.100,Positive,"0,3563"
20/08/2024,7200,7350,7150,7200,0,102.615.900,Positive,"0,1059"
21/08/2024,7250,7300,7225,7300,-50,88.487.800,Negative,"-0,1814"
22/08/2024,7050,7175,6925,7150,-100,157.323.000,Negative,-0.296
23/08/2024,7050,7075,6975,7000,50,111.752.100,Neutral,0.0
26/08/2024,7050,7100,7000,7050,0,78.515.400,Positive,"0,314"
27/08/2024,7025,7050,6925,7025,0,91.686.700,Positive,"0,5836"
28/08/2024,7225,7225,7000,7025,200,114.606.200,Neutral,0.0
29/08/2024,7100,7300,7100,7300,-200,94.475.900,Neutral,0.0